abs	(mixed $number)
acos	(float $arg)
acosh	(float $arg)
addcslashes	(string $str, string $charlist)
addslashes	(string $str)
apache_child_terminate	(void)
apache_lookup_uri	(string $filename)
apache_note	(string $note_name [, string $note_value])
apache_setenv	(string $variable, string $value [, $bool $walk_to_top])
array	([mixed $...])
array_change_key_case	(array $input [, int $case])
array_chunk	(array $input, int $size [, $bool $preserve_keys])
array_count_values	(array $input)
array_diff	(array $array1, array $array2 [, array $...])
array_fill	(int $start_index, int $num, $mixed $value)
array_filter	(array $input [, $mixed $callback])
array_flip	(array $trans)
array_intersect	(array $array1, array $array2 [, array $...])
array_key_exists	( mixed $key, array $search)
array_keys	(array $input [, $mixed $search_value])
array_map	(mixed $callback, array $arr1 [, array $arr2...])
array_merge	(array $matrix1, array $matrix2 [, ...])
array_merge_recursive	(array $array1, array $array2 [, array $...])
array_multisort	(array $ar1 [, $mixed $arg [, $mixed $... [, array $...]]])
array_pad	(array $input, int $pad_size, $mixed $pad_value)
array_pop	(array array)
array_push	(array $array, $mixed $var [, $mixed $...])
array_rand	(array $input [, int $num_req])
array_reduce	(array $input, $mixed $callback [, int $initial])
array_reverse	(array array [, $bool $preserve_keys])
array_search	(mixed $needle, array $haystack [, $bool $strict])
array_shift	(array $matriz)
array_slice	(array $array, int $offset [, int $length])
array_splice	(array $input, int $offset [, int $length [, array $replacement]])
array_sum	(array array)
array_unique	(array $array)
array_unshift	(array $array, $mixed $var [, $mixed $...])
array_values	(array $input)
array_walk	(array $matrix, string $func, mixed $otherstuff)
arsort	(array array [, int $sort_flags])
ascii2ebcdic	(string $ascii_str)
asin	(float $arg)
asinh	(float $arg)
asort	(array $matrix)
aspell_check	(int $dictionary_link, string $word)
aspell_check_raw	(int $dictionary_link, string $word)
aspell_new	(string $master [, string $personal])
aspell_suggest	(int $dictionary_link, string $word)
assert	(string|bool $assertion)
assert_options	(int $what [, $mixed $value])
atan	(float $arg)
atan2	(float $y, $float $x)
atanh	(float $arg)
base_convert	(string $number, int $frombase, int $tobase)
base64_decode	(string $encoded_data)
base64_encode	(string $data)
basename	(string $path [, string $suffix])
bcadd	(string $left_operand, string $right_operand [, int $scale])
bccomp	(string $left_operand, string $right_operand [, int $scale])
bcdiv	(string $left_operand, string $right_operand [, int $scale])
bcmod	(string $left_operand, string $modulus)
bcmul	(string $left_operand, string $right_operand [, int $scale])
bcpow	(string $x, string $y [, int $scale])
bcscale	(int $scale)
bcsqrt	(string $operand [, int $scale])
bcsub	(string $left_operand, string $right_operand [, int $scale])
bin2hex	(string $str)
bind_textdomain_codeset	(string $domain, string $codeset)
bindec	(string $binary_string)
bindtextdomain	(string $domain, string $directory)
bzclose	(resource $bz)
bzcompress	(string $source [, int $blocksize [, int $workfactor]])
bzdecompress	(string $source [, int $small])
bzerrno	(resource $bz)
bzerror	(resource $bz)
bzerrstr	(resource $bz)
bzflush	(resource $bz)
bzopen	(string $filename, string $mode)
bzread	(resource $bz [, int $length])
bzwrite	(resource $bz, string $data [, int $length])
cal_days_in_month	(int $calendar, int $month, int $year)
cal_from_jd	(int $jd, int $calendar)
cal_info	(int $calendar)
cal_to_jd	(int $calendar, int $month, int $day, int $year)
call_user_func	(string $function_name [, $mixed $parameter [, $mixed $...]])
call_user_func_array	(string $function_name [, array $paramarr])
call_user_method	(string $method_name, object $obj [, mixed $parameter [, mixed ...]])
call_user_method_array	(string $method_name, $object $obj [, array $paramarr])
ccvs_add	(string $session, string $invoice, string $argtype, string $argval)
ccvs_auth	(string $session, string $invoice)
ccvs_command	(string $session, string $type, string $argval)
ccvs_count	(string $session, string $type)
ccvs_delete	(string $session, string $invoice)
ccvs_done	(string $sess)
ccvs_init	(string $name)
ccvs_lookup	(string $session, string $invoice, int $inum)
ccvs_new	(string $session, string $invoice)
ccvs_report	(string $session, string $type)
ccvs_return	(string $session, string $invoice)
ccvs_reverse	(string $session, string $invoice)
ccvs_sale	(string $session, string $invoice)
ccvs_status	(string $session, string $invoice)
ccvs_textvalue	(string $session)
ccvs_void	(string $session, string $invoice)
ceil	(float $value)
chdir	(string $directory)
checkdate	(int $month, int $day, int $year)
checkdnsrr	(string $host [, string $type])
checkin	(array $parameter)
chgrp	(string $filename, $mixed $group)
children	(array $parameter)
chmod	(string $filename, int $mode)
chown	(string $filename, $mixed $user)
chr	(int $ascii)
chroot	(string $directory)
chunk_split	(string $body [, int $chunklen [, string $end]])
class_exists	(string $class_name)
closedir	(resource $dir_handle)
closelog	(void)
COM::COM	(string $module_name [, string $server_name [, int $codepage]])
com_addref	(void)
com_get	(resource $com_object, string $property)
com_invoke	(resource $com_object, string $function_name [, $mixed $function $parameters, $...])
com_isenum	(object $com_module)
com_load	(string $module $name [, string $server $name [, int $codepage]])
com_load_typelib	(string $typelib_name [, int $case_insensitive])
com_propget	(resource $com_object, string $property)
com_propput	(resource $com_object, string $property, $mixed $value)
com_propset	(resource $com_object, string $property, $mixed $value)
com_release	(void)
com_set	(resource $com_object, string $property, $mixed $value)
compact	(string varname | array varnames [, ...])
connection_aborted	(void)
connection_status	(void)
connection_timeout	(void)
constant	(string $name)
convert_cyr_string	(string $str, string $from, string $to)
copy	(string $source, string $dest)
cos	(float $arg)
cosh	(float $arg)
count	(mixed $var)
count_chars	(string $string [, $mode])
cpdf_add_annotation	(int $pdf $document, $float $llx, $float $lly, $float $urx, $float $ury, string $title, string $content [, int $mode])
cpdf_add_outline	(int $pdf document, string $text)
cpdf_arc	(int $pdf $document, $float $x-coor, $float $y-coor, $float $radius, $float $start, $float $end [, int $mode])
cpdf_begin_text	(int $pdf $document)
cpdf_circle	(int $pdf $document, $float $x-coor, $float $y-coor, $float $radius [, int $mode])
cpdf_clip	(int $pdf document)
cpdf_close	(int $pdf $document)
cpdf_closepath	(int $pdf $document)
cpdf_closepath_fill_stroke	(int $pdf $document)
cpdf_closepath_stroke	(int $pdf $document)
cpdf_continue_text	(int $pdf $document, string $text)
cpdf_curveto	(int $pdf $document, $float $x1, $float $y1, $float $x2, $float $y2, $float $x3, $float $y3 [, int $mode])
cpdf_end_text	(int $pdf $document)
cpdf_fill	(int $pdf $document)
cpdf_fill_stroke	(int $pdf $document)
cpdf_finalize	(int $pdf $document)
cpdf_finalize_page	(int $pdf $document, int $page $number)
cpdf_global_set_document_limits	(int $maxpages, int $maxfonts, int $maximages, int $maxannotations, int $maxobjects)
cpdf_import_jpeg	(int $pdf $document, string $file $name, $float $x-coor, $float $y-coor, $float $angle, $float $width, $float $height, $float $x-scale, $float $y-scale [, int $mode])
cpdf_lineto	(int $pdf $document, $float $x-coor, $float $y-coor [, int $mode])
cpdf_moveto	(int $pdf $document, $float $x-coor, $float $y-coor [, int $mode])
cpdf_newpath	(int $pdf $document)
cpdf_open	(int $compression [, string $filename])
cpdf_output_buffer	(int $pdf $document)
cpdf_page_init	(int $pdf $document, int $page $number, int $orientation, $float $height, $float $width [, $float $unit])
cpdf_place_inline_image	(int $pdf $document, int $image, $float $x-coor, $float $y-coor, $float $angle, $float $width, $float $height [, int $mode])
cpdf_rect	(int $pdf $document, $float $x-coor, $float $y-coor, $float $width, $float $height [, int $mode])
cpdf_restore	(int $pdf document)
cpdf_rlineto	(int $pdf $document, $float $x-coor, $float $y-coor [, int $mode])
cpdf_rmoveto	(int $pdf $document, $float $x-coor, $float $y-coor [, int $mode])
cpdf_rotate	(int $pdf $document, $float $angle)
cpdf_rotate_text	(int $pdfdoc, $float $angle)
cpdf_save	(int $pdf $document)
cpdf_save_to_file	(int $pdf $document, string $filename)
cpdf_scale	(int $pdf $document, $float $x-scale, $float $y-scale)
cpdf_set leading	(int $pdf document, double $distance)
cpdf_set_action_url	(int $pdfdoc, $float $xll, $float $yll, $float $xur, $float $xur, string $url [, int $mode])
cpdf_set_char_spacing	(int $pdf $document, $float $space)
cpdf_set_creator	(string $creator)
cpdf_set_current_page	(int $pdf $document, int $page $number)
cpdf_set_font	(int $pdf $document, string $font $name, $float $size, string $encoding)
cpdf_set_font_directories	(int $pdfdoc, string $pfmdir, string $pfbdir)
cpdf_set_font_map_file	(int $pdfdoc, string $filename)
cpdf_set_horiz_scaling	(int $pdf $document, $float $scale)
cpdf_set_keywords	(string $keywords)
cpdf_set_page_animation	(int $pdf $document, int $transition, $float $duration)
cpdf_set_subject	(string $subject)
cpdf_set_text_matrix	(int $pdf $document, array $matrix)
cpdf_set_text_pos	(int $pdf $document, $float $x-coor, $float $y-coor [, int $mode])
cpdf_set_text_rendering	(int $pdf $document, int $mode)
cpdf_set_text_rise	(int $pdf $document, $float $value)
cpdf_set_title	(string $title)
cpdf_set_viewer_preferences	(int $pdfdoc, array $preferences)
cpdf_set_word_spacing	(int $pdf $document, $float $space)
cpdf_setdash	(int $pdf $document, $float $white, $float $black)
cpdf_setflat	(int $pdf $document, $float $value)
cpdf_setgray	(int $pdf $document, $float $gray $value)
cpdf_setgray_fill	(int $pdf $document, $float $value)
cpdf_setgray_stroke	(int $pdf $document, $float $gray $value)
cpdf_setlinecap	(int $pdf $document, int $value)
cpdf_setlinejoin	(int $pdf $document, $long $value)
cpdf_setlinewidth	(int $pdf $document, $float $width)
cpdf_setmiterlimit	(int $pdf $document, $float $value)
cpdf_setrgbcolor	(int $pdf $document, $float $red $value, $float $green $value, $float $blue $value)
cpdf_setrgbcolor_fill	(int $pdf $document, $float $red $value, $float $green $value, $float $blue $value)
cpdf_setrgbcolor_stroke	(int $pdf $document, $float $red $value, $float $green $value, $float $blue $value)
cpdf_show	(int $pdf $document, string $text)
cpdf_show_xy	(int $pdf $document, string $text, $float $x-coor, $float $y-coor [, int $mode])
cpdf_stringwidth	(int $pdf $document, string $text)
cpdf_stroke	(int $pdf $document)
cpdf_text	(int $pdf $document, string $text, $float $x-coor, $float $y-coor [, int $mode [, $float $orientation [, int $alignmode]]])
cpdf_translate	(int $pdf $document, $float $x-coor, $float $y-coor [, int $mode])
crack_check	([resource $dictionary, string $password])
crack_closedict	([resource $dictionary])
crack_getlastmessage	(void)
crack_opendict	(string $dictionary)
crc32	(string $str)
create_function	(string $args, string $code)
crypt	(string $str [, string $salt])
ctype_cntrl	(string $text)
ctype_digit	(string $text)
ctype_graph	(string $text)
ctype_lower	(string $text)
ctype_print	(string $text)
ctype_punct	(string $text)
ctype_space	(string $text)
ctype_upper	(string $text)
ctype_xdigit	(string $text)
curl_close	(int $ch)
curl_errno	(int $ch)
curl_error	(int $ch)
curl_exec	(int $ch)
curl_getinfo	(int $ch, int $opt)
curl_init	([string $url])
curl_setopt	(int $ch, string $option, $mixed $value)
curl_version	(void)
current	(array array)
cybercash_base64_decode	(string $inbuff)
cybercash_base64_encode	(string $inbuff)
cybercash_decr	(string $wmk, string $sk, string $inbuff)
cybercash_encr	(string $wmk, string $sk, string $inbuff)
cybermut_creerformulairecm	(string $url_CM, string $version, string $TPE, string $montant, string $ref_commande, string $texte_libre, string $url_retour, string $url_retour_ok, string $url_retour_err, string $langue, string $code_societe, string $texte_bouton)
cybermut_creerreponsecm	(string $phrase)
cybermut_testmac	(string $code_MAC, string $version, string $TPE, string $cdate, string $montant, string $ref_commande, string $texte_libre, string $code-retour)
cyrus_authenticate	(resource $connection [, string $mechlist [, string $service [, string $user [, int $minssf [, int $maxssf]]]]])
cyrus_bind	(resource $connection, array $callbacks)
cyrus_close	(resource $connection)
cyrus_connect	([string $host [, string $port [, int $flags]]])
cyrus_query	(resource $connection, string $query)
cyrus_unbind	(resource $connection, string $trigger_name)
date	(string $format [, int $timestamp])
dba_close	(int $handle)
dba_delete	(string $key, int $handle)
dba_exists	(string $key, int $handle)
dba_fetch	(string $key, int $handle)
dba_firstkey	(int $handle)
dba_insert	(string $key, string $value, int $handle)
dba_nextkey	(int $handle)
dba_open	(string $path, string $mode, string $handler [, $...])
dba_optimize	(int $handle)
dba_replace	(string $key, string $value, int $handle)
dba_sync	(int $handle)
dbase_add_record	(int $dbase_identifier, array $record)
dbase_close	(int $dbase_identifier)
dbase_create	(string $filename, array $fields)
dbase_delete_record	(int $dbase_identifier, int $record)
dbase_get_record	(int $dbase_identifier, int $record)
dbase_get_record_with_names	(int $dbase_identifier, int $record)
dbase_numrecords	(int $dbase_identifier)
dbase_open	(string $filename, int $flags)
dbase_pack	(int $dbase_identifier)
dbase_replace_record	(int $dbase_identifier, array $record, int $dbase_record_number)
dblist	(void)
dbmclose	(int $dbm_identifier)
dbmdelete	(int $dbm_identifier, string $key)
dbmexists	(int $dbm_identifier, string $key)
dbmfetch	(int $dbm_identifier, string $key)
dbmfirstkey	(int $dbm_identifier)
dbminsert	(int $dbm_identifier, string $key, string $value)
dbmnextkey	(int $dbm_identifier, string $key)
dbmopen	(string $filename, string $flags)
dbmreplace	(int $dbm_identifier, string $key, string $value)
dbplus_add	(resource $relation, array $tuple)
dbplus_aql	(string $query [, string $server [, string $dbpath]])
dbplus_chdir	([string $newdir])
dbplus_close	(resource $relation)
dbplus_errcode	(int $errno)
dbplus_errno	(void)
dbplus_find	(resource $relation, array $constraints, $mixed $tuple)
dbplus_first	(resource $relation, array $tuple)
dbplus_flush	(resource $relation)
dbplus_freealllocks	(void)
dbplus_freelock	(resource $relation, string $tname)
dbplus_freerlocks	(resource $relation)
dbplus_getlock	(resource $relation, string $tname)
dbplus_getunique	(resource $relation, int $uniqueid)
dbplus_info	(resource $relation, string $key, array $)
dbplus_last	(resource $relation, array $tuple)
dbplus_lockrel	(resource $relation)
dbplus_open	(string $name)
dbplus_prev	(resource $relation, array $tuple)
dbplus_rchperm	(resource $relation, int $mask, string $user, string $group)
dbplus_rcreate	(string $name, $mixed $domlist [, $boolean $overwrite])
dbplus_rcrtexact	(string $name, resource $relation, $boolean $overwrite)
dbplus_rcrtlike	(string $name, resource $relation, int $flag)
dbplus_resolve	(string $relation_name)
dbplus_restorepos	(resource $relation, array $tuple)
dbplus_rkeys	(resource $relation, $mixed $domlist)
dbplus_ropen	(string $name)
dbplus_rquery	(string $query, string $dbpath)
dbplus_rrename	(resource $relation, string $name)
dbplus_runlink	(resource $relation)
dbplus_rzap	(resource $relation)
dbplus_savepos	(resource $relation)
dbplus_setindex	(resource $relation, string $idx_name)
dbplus_setindexbynumber	(resource $relation, int $idx_number)
dbplus_sql	(string $query, string $server, string $dbpath)
dbplus_tcl	(int $sid, string $script)
dbplus_tremove	(resource $relation, array $tuple [, array $current])
dbplus_undo	(resource $relation)
dbplus_undoprepare	(resource $relation)
dbplus_unlockrel	(resource $relation)
dbplus_update	(resource $relation, array $old, array $new)
dbplus_xlockrel	(resource $relation)
dbplus_xunlockrel	(resource $relation)
dbstat	(array $parameter)
dbx_close	(object $link_identifier)
dbx_compare	(array $row_a, array $row_b, string $column_key [, int $flags])
dbx_connect	(mixed $module, string $host, string $database, string $username, string $password [, int $persistent])
dbx_query	(object $link_identifier, string $sql_statement [, $long $flags])
dbx_sort	(object $result, string $user_compare_function)
dcgettext	(string $domain, string $message, int $category)
dcngettext	(string $domain, string $msgid1, string $msgid2, int $n, int $category)
dcstat	(array $parameter)
debugger_off	(void)
debugger_on	(string $address)
decbin	(int $number)
dechex	(int $number)
decoct	(int $number)
define	(string $name, $mixed $value [, $bool $case_insensitive])
define_syslog_variables	(void)
defined	(string $name)
deg2rad	(float $number)
delete	(string $file)
description	(void $)
dgettext	(string $domain, string $message)
dio_close	(resource $fd)
dio_fcntl	(resource $fd, int $cmd [, $mixed $arg])
dio_open	(string $filename, int $flags [, int $mode])
dio_read	(resource $fd [, int $n])
dio_seek	(resource $fd, int $pos, int $whence)
dio_stat	(resource $fd)
dio_truncate	(resource $fd, int $offset)
dio_write	(resource $fd, string $data [, int $len])
dirname	(string $path)
diskfreespace	(string $directory)
dl	(string $library)
dngettext	(string $domain, string $msgid1, string $msgid2, int $n)
DomAttribute-&#62;name	(void)
DomAttribute-specified	(void)
DomAttribute-value	(void)
DomDocument-add_root	(string $name)
DomDocument-create_attribute	(string $name, string $value)
DomDocument-create_cdata_section	(string $content)
DomDocument-create_comment	(string $content)
DomDocument-create_element	(string $name)
DomDocument-create_entity_reference	(string $content)
DomDocument-create_processing_instruction	(string $content)
DomDocument-create_text_node	(string $content)
DomDocument-doctype	(void)
DomDocument-document_element	(void)
DomDocument-dump_file	(string $filename [, $bool $compressionmode [, $bool $format]])
DomDocument-dump_mem	([bool $format])
DomDocument-get_element_by_id	(string $id)
DomDocument-get_elements_by_tagname	(string $name)
DomDocument-html_dump_mem	(void)
DomDocumentType-entities	(void)
DomDocumentType-internal_subset	(void)
DomDocumentType-name	(void)
DomDocumentType-notations	(void)
DomDocumentType-public_id	(void)
DomElement-get_attribute	(string $name)
DomElement-get_attribute_node	(object $attr)
DomElement-get_elements_by_tagname	(string $name)
DomElement-has_attribute	(string $name)
DomElement-remove_attribute	(string $name)
DomElement-set_attribute	(string $name, string $value)
DomElement-set_attribute_node	(object $attr)
DomElement-tagname	(void)
DomNode-append_child	(object $newnode)
DomNode-append_sibling	(object $newnode)
DomNode-attributes	(void)
DomNode-child_nodes	(void)
DomNode-clone_node	(void)
DomNode-dump_node	(void)
DomNode-first_child	(void)
DomNode-get_content	(void)
DomNode-has_attributes	(void)
DomNode-has_child_nodes	(void)
DomNode-insert_before	(object $newnode, $object $refnode)
DomNode-last_child	(void)
DomNode-next_sibling	(void)
DomNode-node_name	(void)
DomNode-node_type	(void)
DomNode-node_value	(void)
DomNode-owner_document	(void)
DomNode-parent_node	(void)
DomNode-prefix	(void)
DomNode-previous_sibling	(void)
DomNode-remove_child	(object $oldchild)
DomNode-replace_node	(void)
DomNode-set_content	(void)
DomNode-set_name	(void)
DomNode-unlink_node	(void)
DomProcessingInstruction-data	(void)
DomProcessingInstruction-target	(void)
domxml_new_doc	(string $version)
domxml_open_mem	(string $str)
domxml_version	(void)
domxml_xmltree	(string $str)
dstanchors	(array $parameter)
dstofsrcanchors	(array $parameter)
each	(array $array)
easter_date	(int $year)
easter_days	(int $year)
ebcdic2ascii	(string $ebcdic_str)
echo	(string $arg1 [, string $argn...])
empty	(mixed $var)
end	(array array)
ereg	(string $pattern, string $string [, array $regs])
ereg_replace	(string $pattern, string $replacement, string $string)
eregi	(string $pattern, string $string [, array $regs])
eregi_replace	(string $pattern, string $replacement, string $string)
error_log	(string $message [, int $message_type [, string $destination [, string $extra_headers]]])
error_reporting	([int $level])
escapeshellarg	(string $arg)
escapeshellcmd	(string $command)
eval	(string $code_str)
exec	(string $command [, string $array [, int $return_var]])
exif_imagetype	(string $filename)
exif_read_data	(string $filename [, string $sections [, $bool $arrays [, $bool $thumbnail]]])
exif_thumbnail	(string $filename [, int $&#38;width [, int $&#38;height]])
exit	([string $status])
exit	(int $status)
exp	(float $arg)
explode	(string $separator, string $string [, int $limit])
expm1	(float $number)
extension_loaded	(string $name)
extract	(array $var_array [, int $extract_type [, string $prefix]])
ezmlm_hash	(string $addr)
fbsql_affected_rows	([int $link_identifier])
fbsql_autocommit	(resource $link_identifier [, $bool $OnOff])
fbsql_change_user	(string $user, string $password [, string $database [, int $link_identifier]])
fbsql_close	([resource $link_identifier])
fbsql_commit	([resource $link_identifier])
fbsql_create_blob	(string $blob_data [, resource $link_identifier])
fbsql_create_clob	(string $clob_data [, resource $link_identifier])
fbsql_create_db	(string $database $name [, resource $link_identifier])
fbsql_data_seek	(resource $result_identifier, int $row_number)
fbsql_database_password	(resource $link_identifier [, string $database_password])
fbsql_db_query	(string $database, string $query [, resource $link_identifier])
fbsql_drop_db	(string $database_name [, resource $link_identifier])
fbsql_errno	([resource $link_identifier])
fbsql_error	([resource $link_identifier])
fbsql_fetch_array	(resource $result [, int $result_type])
fbsql_fetch_assoc	(resource $result)
fbsql_fetch_field	(resource $result [, int $field_offset])
fbsql_fetch_lengths	([resource $result])
fbsql_fetch_object	(resource $result [, int $result_type])
fbsql_fetch_row	(resource $result)
fbsql_field_flags	(resource $result, int $field_offset)
fbsql_field_len	(resource $result, int $field_offset)
fbsql_field_name	(resource $result, int $field_index)
fbsql_field_seek	(resource $result, int $field_offset)
fbsql_field_table	(resource $result, int $field_offset)
fbsql_field_type	(resource $result, int $field_offset)
fbsql_free_result	(int $result)
fbsql_get_autostart_info	([resource $link_identifier])
fbsql_hostname	(resource $link_identifier [, string $host_name])
fbsql_insert_id	([resource $link_identifier])
fbsql_list_dbs	([resource $link_identifier])
fbsql_list_fields	(string $database_name, string $table_name [, resource $link_identifier])
fbsql_list_tables	(string $database [, resource $link_identifier])
fbsql_next_result	(int $result_id)
fbsql_num_fields	(resource $result)
fbsql_num_rows	(resource $result)
fbsql_password	(resource $link_identifier [, string $password])
fbsql_pconnect	([string $hostname [, string $username [, string $password]]])
fbsql_query	(string $query [, resource $link_identifier])
fbsql_read_blob	(string $blob_handle [, resource $link_identifier])
fbsql_read_clob	(string $clob_handle [, resource $link_identifier])
fbsql_result	(resource $result, int $row [, $mixed $field])
fbsql_rollback	([resource $link_identifier])
fbsql_select_db	(string $database_name [, resource $link_identifier])
fbsql_set_lob_mode	(resource $result, string $database_name)
fbsql_set_transaction	(resource $link_identifier, int $Locking, int $Isolation)
fbsql_start_db	(string $database_name [, resource $link_identifier])
fbsql_stop_db	(string $database_name [, resource $link_identifier])
fbsql_tablename	(resource $result, int $i)
fbsql_username	(resource $link_identifier [, string $username])
fbsql_warnings	([bool $OnOff])
fclose	(int $fp)
fdf_add_template	(int $fdfdoc, int $newpage, string $filename, string $template, int $rename)
fdf_close	(int $fdf_document)
fdf_create	(void)
fdf_get_file	(int $fdf_document)
fdf_get_status	(int $fdf_document)
fdf_get_value	(int $fdf_document, string $fieldname)
fdf_next_field_name	(int $fdf_document [, string $fieldname])
fdf_open	(string $filename)
fdf_save	(string $filename)
fdf_set_encoding	(int $fdf_document, string $encoding)
fdf_set_file	(int $fdf_document, string $filename)
fdf_set_flags	(int $fdf_document, string $fieldname, int $whichFlags, int $newFlags)
fdf_set_javascript_action	(int $fdf_document, string $fieldname, int $trigger, string $script)
fdf_set_opt	(int $fdf_document, string $fieldname, int $element, string $str1, string $str2)
fdf_set_status	(int $fdf_document, string $status)
fdf_set_submit_form_action	(int $fdf_document, string $fieldname, int $trigger, string $script, int $flags)
fdf_set_value	(int $fdf_document, string $fieldname, string $value, int $isName)
feof	(int $fp)
fflush	(int $fp)
fgetc	(int $fp)
fgetcsv	(int $fp, int $length [, string $delimiter])
fgets	(int $fp [, int $length])
fgetss	(int $fp, int $length [, string $allowable_tags])
file	(string $filename [, int $use_include_path])
file_exists	(string $filename)
file_get_contents	(string $filename [, int $use_include_path])
file_get_wrapper_data	(int $fp)
file_register_wrapper	(string $protocol, string $classname)
fileatime	(string $filename)
filectime	(string $filename)
filegroup	(string $filename)
fileinode	(string $filename)
filemtime	(string $filename)
fileowner	(string $filename)
fileperms	(string $filename)
filepro	(string $directory)
filepro_fieldcount	(void)
filepro_fieldname	(int $field_number)
filepro_fieldtype	(int $field_number)
filepro_fieldwidth	(int $field_number)
filepro_retrieve	(int $row_number, int $field_number)
filepro_rowcount	(void)
filesize	(string $filename)
filetype	(string $filename)
find	(array $parameter)
floatval	(mixed $var)
flock	(int $fp, int $operation [, int $wouldblock])
floor	(float $value)
flush	(void)
fopen	(string $filename, string $mode [, int $use_include_path])
fpassthru	(int $fp)
fputs	(int $fp, string $str [, int $length])
fread	(int $fp, int $length)
frenchtojd	(int $month, int $day, int $year)
fribidi_log2vis	(string $str, string $direction, int $charset)
fscanf	(int $handle, string $format [, string $var1])
fseek	(int $fp, int $offset [, int $whence])
fsockopen	(string $hostname, int $port [, int $errno [, string $errstr [, $float $timeout]]])
ftell	(int $fp)
ftok	(string $pathname, string $proj)
ftp_cdup	(resource $ftp_stream)
ftp_chdir	(resource $ftp_stream, string $directory)
ftp_close	(resource $ftp_stream)
ftp_connect	(string $host [, int $port [, int $timeout]])
ftp_delete	(resource $ftp_stream, string $path)
ftp_exec	(resource $stream, string $command)
ftp_fget	(resource $ftp_stream, resource $fp, string $remote_file, int $mode)
ftp_fput	(resource $ftp_stream, string $remote_file, resource $fp, int $mode)
ftp_get	(resource $ftp_stream, string $local_file, string $remote_file, int $mode)
ftp_login	(resource $ftp_stream, string $username, string $password)
ftp_mdtm	(resource $ftp_stream, string $remote_file)
ftp_mkdir	(resource $ftp_stream, string $directory)
ftp_nlist	(resource $ftp_stream, string $directory)
ftp_pasv	(resource $ftp_stream, $bool $pasv)
ftp_put	(resource $ftp_stream, string $remote_file, string $local_file, int $mode)
ftp_pwd	(resource $ftp_stream)
ftp_quit	(resource $ftp_stream)
ftp_rawlist	(resource $ftp_stream, string $directory)
ftp_rename	(resource $ftp_stream, string $from, string $to)
ftp_rmdir	(resource $ftp_stream, string $directory)
ftp_set_option	(resource $stream, int $option, $mixed $value)
ftp_site	(resource $ftp_stream, string $cmd)
ftp_size	(resource $ftp_stream, string $remote_file)
ftp_systype	(resource $ftp_stream)
ftruncate	(int $fp, int $size)
ftstat	(array $parameter)
func_get_arg	(int $arg_num)
func_get_args	(void)
func_num_args	(void)
function_exists	(string $function_name)
fwrite	(int $fp, string $string [, int $length])
get_cfg_var	(string $varname)
get_class	(object $obj)
get_class_methods	(mixed $class_name)
get_class_vars	(string $class_name)
get_current_user	(void)
get_defined_constants	(void)
get_defined_functions	(void)
get_defined_vars	(void)
get_extension_funcs	(string $module_name)
get_html_translation_table	(int $table [, int $quote_style])
get_included_files	(void)
get_loaded_extensions	(void)
get_magic_quotes_gpc	(void)
get_magic_quotes_runtime	(void)
get_meta_tags	(string $filename [, int $use_include_path])
get_object_vars	(object $obj)
get_parent_class	(mixed $obj)
get_required_files	(void)
get_resource_type	(resource $handle)
getallheaders	(void)
getcwd	(void)
getdate	([int $timestamp])
getenv	(string $varname)
gethostbyaddr	(string $ip_address)
gethostbyname	(string $hostname)
gethostbynamel	(string $hostname)
getimagesize	(string $filename [, array $imageinfo])
getlastmod	(void)
getmxrr	(string $hostname, array $mxhosts [, array $weight])
getmygid	(void)
getmyinode	(void)
getmyuid	(void)
getprotobyname	(string $name)
getprotobynumber	(int $number)
getrandmax	(void)
getrusage	([int $who])
getservbyname	(string $service, string $protocol)
getservbyport	(int $port, string $protocol)
gettext	(string $message)
gettimeofday	(void)
gettype	(mixed $var)
gmdate	(string $format [, int $timestamp])
gmmktime	(int $hour, int $minute, int $second, int $month, int $day, int $year [, int $is_dst])
gmp_abs	(resource $a)
gmp_add	(resource $a, resource $b)
gmp_and	(resource $a, resource $b)
gmp_clrbit	(resource $&#38;a, int $index)
gmp_cmp	(resource $a, resource $b)
gmp_com	(resource $a)
gmp_div	(resource $a, resource $b)
gmp_div_q	(resource $a, resource $b [, int $round])
gmp_div_qr	(resource $n, resource $d [, int $round])
gmp_div_r	(resource $n, resource $d [, int $round])
gmp_divexact	(resource $n, resource $d)
gmp_fact	(int $a)
gmp_gcd	(resource $a, resource $b)
gmp_gcdext	(resource $a, resource $b)
gmp_hamdist	(resource $a, resource $b)
gmp_init	(mixed $number)
gmp_intval	(resource $gmpnumber)
gmp_invert	(resource $a, resource $b)
gmp_jacobi	(resource $a, resource $p)
gmp_legendre	(resource $a, resource $p)
gmp_mod	(resource $n, resource $d)
gmp_mul	(resource $a, resource $b)
gmp_neg	(resource $a)
gmp_or	(resource $a, resource $b)
gmp_perfect_square	(resource $a)
gmp_popcount	(resource $a)
gmp_pow	(resource $base, int $exp)
gmp_powm	(resource $base, resource $exp, resource $mod)
gmp_prob_prime	(resource $a [, int $reps])
gmp_random	(int $limiter)
gmp_scan0	(resource $a, int $start)
gmp_scan1	(resource $a, int $start)
gmp_setbit	(resource $&#38;a, int $index [, $bool $set_clear])
gmp_sign	(resource $a)
gmp_sqrt	(resource $a)
gmp_sqrtrm	(resource $a)
gmp_strval	(resource $gmpnumber [, int $base])
gmp_xor	(resource $a, resource $b)
gmstrftime	(string $format [, int $timestamp])
gregoriantojd	(int $month, int $day, int $year)
gzclose	(int $zp)
gzcompress	(string $data [, int $level])
gzdeflate	(string $data [, int $level])
gzencode	(string $data [, int $level [, int $encoding_mode]])
gzeof	(int $zp)
gzfile	(string $filename [, int $use_include_path])
gzgetc	(int $zp)
gzgets	(int $zp, int $length)
gzgetss	(int $zp, int $length [, string $allowable_tags])
gzinflate	(string $data [, int $length])
gzopen	(string $filename, string $mode [, int $use_include_path])
gzpassthru	(int $zp)
gzputs	(int $zp, string $str [, int $length])
gzread	(int $zp, int $length)
gzrewind	(int $zp)
gzseek	(int $zp, int $offset)
gztell	(int $zp)
gzwrite	(int $zp, string $string [, int $length])
header	(string string [, $bool $replace])
headers_sent	(void)
hebrev	(string $hebrew_text [, int $max_chars_per_line])
hebrevc	(string $hebrew_text [, int $max_chars_per_line])
hexdec	(string $hex_string)
highlight_file	(string $filename [, $bool $return])
highlight_string	(string $str [, $bool $return])
htmlentities	(string string [, int $quote_style [, string $charset]])
htmlspecialchars	(string string [, int $quote_style [, string $charset]])
hw_api-object	(array $parameter)
hw_api_object	(array $parameter)
hw_array2objrec	(array $object_array)
hw_changeobject	(int $link, int $objid, array $attributes)
hw_children	(int $connection, int $objectID)
hw_childrenobj	(int $connection, int $objectID)
hw_close	(int $connection)
hw_connect	(string $host, int $port, string $username, string $password)
hw_connection_info	(int $link)
hw_cp	(int $connection, array $object_id_array, int $destination $id)
hw_deleteobject	(int $connection, int $object_to_delete)
hw_docbyanchor	(int $connection, int $anchorID)
hw_docbyanchorobj	(int $connection, int $anchorID)
hw_document_attributes	(int $hw_document)
hw_document_bodytag	(int $hw_document)
hw_document_content	(int $hw_document)
hw_document_setcontent	(int $hw_document, string $content)
hw_document_size	(int $hw_document)
hw_dummy	(int $link, int $id, int $msgid)
hw_edittext	(int $connection, int $hw_document)
hw_error	(int $connection)
hw_errormsg	(int $connection)
hw_free_document	(int $hw_document)
hw_getanchors	(int $connection, int $objectID)
hw_getanchorsobj	(int $connection, int $objectID)
hw_getandlock	(int $connection, int $objectID)
hw_getchildcoll	(int $connection, int $objectID)
hw_getchildcollobj	(int $connection, int $objectID)
hw_getchilddoccoll	(int $connection, int $objectID)
hw_getchilddoccollobj	(int $connection, int $objectID)
hw_getobject	(int $connection, $[int|array] $objectID, string $query)
hw_getobjectbyquerycoll	(int $connection, int $objectID, string $query, int $max_hits)
hw_getobjectbyqueryobj	(int $connection, string $query, int $max_hits)
hw_getparents	(int $connection, int $objectID)
hw_getparentsobj	(int $connection, int $objectID)
hw_getrellink	(int $link, int $rootid, int $sourceid, int $destid)
hw_getremote	(int $connection, int $objectID)
hw_getremotechildren	(int $connection, string $object $record)
hw_getsrcbydestobj	(int $connection, int $objectID)
hw_gettext	(int $connection, int $objectID [, $mixed $rootID/prefix])
hw_identify	(string $username, string $password)
hw_incollections	(int $connection, array $object_id_array, array $collection_id_array, int $return_collections)
hw_info	(int $connection)
hw_inscoll	(int $connection, int $objectID, array $object_array)
hw_insdoc	(int $connection, int $parentID, string $object_record, string $text)
hw_insertanchors	(int $hwdoc, array $anchorecs, array $dest [, array $urlprefixes])
hw_insertdocument	(int $connection, int $parent_id, int $hw_document)
hw_mapid	(int $connection, int $server $id, int $object $id)
hw_modifyobject	(int $connection, int $object_to_change, array $remove, array $add, int $mode)
hw_mv	(int $connection, array $object $id $array, int $source $id, int $destination $id)
hw_new_document	(string $object_record, string $document_data, int $document_size)
hw_objrec2array	(string $object_record [, array $format])
hw_output_document	(int $hw_document)
hw_pconnect	(string $host, int $port, string $username, string $password)
hw_pipedocument	(int $connection, int $objectID)
hw_root	()
hw_setlinkroot	(int $link, int $rootid)
hw_stat	(int $link)
hw_unlock	(int $connection, int $objectID)
hw_who	(int $connection)
hwapi_hgcsp	(string $hostname [, int $port])
hwstat	(array $parameter)
hypot	(float $num1, $float $num2)
ibase_blob_add	(int $blob_id, string $data)
ibase_blob_cancel	(int $blob_id)
ibase_blob_close	(int $blob_id)
ibase_blob_create	([int $link_identifier])
ibase_blob_echo	(string $blob_id_str)
ibase_blob_get	(int $blob_id, int $len)
ibase_blob_import	([int $link_identifier, int $file_id])
ibase_blob_info	(string $blob_id_str)
ibase_blob_open	(string $blob_id)
ibase_close	([int $connection_id])
ibase_commit	([int $link_identifier, int $trans_number])
ibase_connect	(string $database [, string $username [, string $password [, string $charset [, int $buffers [, int $dialect [, string $role]]]]]])
ibase_errmsg	(void)
ibase_execute	(int $query [, int $bind_args])
ibase_fetch_object	(int $result_id)
ibase_fetch_row	(int $result_identifier)
ibase_free_query	(int $query)
ibase_free_result	(int $result_identifier)
ibase_num_fields	(int $result_id)
ibase_pconnect	(string $database [, string $username [, string $password [, string $charset [, int $buffers [, int $dialect [, string $role]]]]]])
ibase_prepare	([int $link_identifier, string $query])
ibase_query	([int $link_identifier, string $query [, int $bind_args]])
ibase_rollback	([int $link_identifier, int $trans_number])
ibase_timefmt	(string $format [, int $columntype])
ibase_trans	([int $trans_args [, int $link_identifier]])
icap_close	(int $icap_stream [, int $flags])
icap_create_calendar	(int $stream_id, string $calendar)
icap_delete_calendar	(int $stream_id, string $calendar)
icap_delete_event	(int $stream_id, int $uid)
icap_fetch_event	(int $stream_id, int $event_id [, int $options])
icap_list_alarms	(int $stream_id, array $date, array $time)
icap_list_events	(int $stream_id, int $begin_date [, int $end_date])
icap_open	(string $calendar, string $username, string $password, string $options)
icap_rename_calendar	(int $stream_id, string $old_name, string $new_name)
icap_reopen	(int $stream_id, string $calendar [, int $options])
icap_snooze	(int $stream_id, int $uid)
icap_store_event	(int $stream_id, $object $event)
iconv	(string $in_charset, string $out_charset, string $str)
iconv_get_encoding	([string $type])
iconv_set_encoding	(string $type, string $charset)
identify	(array $parameter)
ifx_affected_rows	(int $result_id)
ifx_blobinfile_mode	(int $mode)
ifx_byteasvarchar	(int $mode)
ifx_close	([int $link_identifier])
ifx_connect	([string $database [, string $userid [, string $password]]])
ifx_create_blob	(int $type, int $mode, string $param)
ifx_create_char	(string $param)
ifx_do	(int $result_id)
ifx_error	(void)
ifx_errormsg	([int $errorcode])
ifx_fieldtypes	(int $result_id)
ifx_free_blob	(int $bid)
ifx_free_char	(int $bid)
ifx_free_result	(int $result_id)
ifx_get_blob	(int $bid)
ifx_get_char	(int $bid)
ifx_getsqlca	(int $result_id)
ifx_htmltbl_result	(int $result_id [, string $html_table_options])
ifx_nullformat	(int $mode)
ifx_num_fields	(int $result_id)
ifx_num_rows	(int $result_id)
ifx_pconnect	([string $database [, string $userid [, string $password]]])
ifx_prepare	(string $query, int $conn_id [, int $cursor_def, $mixed $blobidarray])
ifx_query	(string $query [, int $link_identifier [, int $cursor_type [, $mixed $blobidarray]]])
ifx_textasvarchar	(int $mode)
ifx_update_blob	(int $bid, string $content)
ifx_update_char	(int $bid, string $content)
ifxus_close_slob	(int $bid)
ifxus_create_slob	(int $mode)
ifxus_free_slob	(int $bid)
ifxus_open_slob	(long $bid, int $mode)
ifxus_read_slob	(long $bid, $long $nbytes)
ifxus_seek_slob	(long $bid, int $mode, $long $offset)
ifxus_tell_slob	(long $bid)
ifxus_write_slob	(long $bid, string $content)
ignore_user_abort	([int $setting])
image2wbmp	(resource $image [, string $filename [, int $threshold]])
imagealphablending	(resource $image, $bool $blendmode)
imagearc	(resource $image, int $cx, int $cy, int $w, int $h, int $s, int $e, int $col)
imagechar	(resource $image, int $font, int $x, int $y, string $c, int $col)
imagecolorallocate	(resource $image, int $red, int $green, int $blue)
imagecolorat	(resource $image, int $x, int $y)
imagecolorclosest	(resource $image, int $red, int $green, int $blue)
imagecolorclosestalpha	(resource $image, int $red, int $green, int $blue, int $alpha)
imagecolorclosesthwb	(resource $image, int $red, int $green, int $blue)
imagecolordeallocate	(resource $image, int $color)
imagecolorexact	(resource $image, int $red, int $green, int $blue)
imagecolorexactalpha	(resource $image, int $red, int $green, int $blue, int $alpha)
imagecolorresolve	(resource $image, int $red, int $green, int $blue)
imagecolorresolvealpha	(resource $image, int $red, int $green, int $blue, int $alpha)
imagecolorset	(resource $image, int $index, int $red, int $green, int $blue)
imagecolorsforindex	(resource $image, int $index)
imagecolorstotal	(resource $image)
imagecolortransparent	(resource $image [, int $color])
imagecopy	(resource $dst_im, resource $src_im, int $dst_x, int $dst_y, int $src_x, int $src_y, int $src_w, int $src_h)
imagecopymerge	(resource $dst_im, resource $src_im, int $dst_x, int $dst_y, int $src_x, int $src_y, int $src_w, int $src_h, int $pct)
imagecopymergegray	(resource $dst_im, resource $src_im, int $dst_x, int $dst_y, int $src_x, int $src_y, int $src_w, int $src_h, int $pct)
imagecopyresampled	(resource $dst_im, resource $src_im, int $dstX, int $dstY, int $srcX, int $srcY, int $dstW, int $dstH, int $srcW, int $srcH)
imagecopyresized	(resource $dst_im, resource $src_im, int $dstX, int $dstY, int $srcX, int $srcY, int $dstW, int $dstH, int $srcW, int $srcH)
imagecreate	(int $x_size, int $y_size)
imagecreatefromgd	(string $filename)
imagecreatefromgd2	(string $filename)
imagecreatefromgd2part	(string $filename, int $srcX, int $srcY, int $width, int $height)
imagecreatefromgif	(string $filename)
imagecreatefromjpeg	(string $filename)
imagecreatefrompng	(string $filename)
imagecreatefromstring	(string $image)
imagecreatefromwbmp	(string $filename)
imagecreatefromxbm	(string $filename)
imagecreatefromxpm	(string $filename)
imagecreatetruecolor	(int $x_size, int $y_size)
imagedashedline	(resource $image, int $x1, int $y1, int $x2, int $y2, int $col)
imagedestroy	(resource $image)
imageellipse	(resource $image, int $cx, int $cy, int $w, int $h, int $col)
imagefill	(resource $image, int $x, int $y, int $col)
imagefilledarc	(resource $image, int $cx, int $cy, int $w, int $h, int $s, int $e, int $col, int $style)
imagefilledellipse	(resource $image, int $cx, int $cy, int $w, int $h, int $col)
imagefilledpolygon	(resource $image, array $points, int $num_points, int $col)
imagefilledrectangle	(resource $image, int $x1, int $y1, int $x2, int $y2, int $col)
imagefilltoborder	(resource $image, int $x, int $y, int $border, int $col)
imagefontheight	(int $font)
imagefontwidth	(int $font)
imageftbbox	(int $size, int $angle, string $font_file, string $text [, array $extrainfo])
imagefttext	(resource $image, int $size, int $angle, int $x, int $y, int $col, string $font_file, string $text [, array $extrainfo])
imagegammacorrect	(resource $image, $float $inputgamma, $float $outputgamma)
imagegd	(resource $image [, string $filename])
imagegd2	(resource $image [, string $filename])
imagegif	(resource $image [, string $filename])
imageinterlace	(resource $image [, int $interlace])
imagejpeg	(resource $image [, string $filename [, int $quality]])
imageline	(resource $image, int $x1, int $y1, int $x2, int $y2, int $col)
imageloadfont	(string $file)
imagepalettecopy	(resource $destination, resource $source)
imagepng	(resource $image [, string $filename])
imagepolygon	(resource $image, array $points, int $num_points, int $col)
imagepsbbox	(string $text, int $font, int $size [, int $space [, int $tightness [, $float $angle]]])
imagepscopyfont	(int $fontindex)
imagepsencodefont	(int $font_index, string $encodingfile)
imagepsextendfont	(int $font_index, $float $extend)
imagepsfreefont	(int $fontindex)
imagepsloadfont	(string $filename)
imagepsslantfont	(int $font_index, $float $slant)
imagepstext	(resource $image, string $text, int $font, int $size, int $foreground, int $background, int $x, int $y [, int $space [, int $tightness [, $float $angle [, int $antialias_steps]]]])
imagerectangle	(resource $image, int $x1, int $y1, int $x2, int $y2, int $col)
imagesetbrush	(resource $image, resource $brush)
imagesetpixel	(resource $image, int $x, int $y, int $col)
imagesetstyle	(resource $image, array $style)
imagesetthickness	(resource $image, int $thickness)
imagesettile	(resource $image, resource $tile)
imagestring	(resource $image, int $font, int $x, int $y, string $s, int $col)
imagestringup	(resource $image, int $font, int $x, int $y, string $s, int $col)
imagesx	(resource $image)
imagesy	(resource $image)
imagetruecolortopalette	(resource $image, $bool $dither, int $ncolors)
imagettfbbox	(int $size, int $angle, string $fontfile, string $text)
imagetypes	(void)
imagewbmp	(resource $image [, string $filename [, int $foreground]])
imap_8bit	(string string)
imap_alerts	(void)
imap_append	(int $imap_stream, string $mbox, string $message [, string $flags])
imap_base64	(string $text)
imap_binary	(string string)
imap_body	(int $imap_stream, int $msg_number [, int $flags])
imap_bodystruct	(int $stream_id, int $msg_no, int $section)
imap_check	(int $imap_stream)
imap_clearflag_full	(int $stream, string $sequence, string $flag, string $options)
imap_close	(int $imap_stream [, int $flags])
imap_createmailbox	(int $imap_stream, string $mbox)
imap_delete	(int $imap_stream, int $msg_number [, int $flags])
imap_deletemailbox	(int $imap_stream, string $mbox)
imap_errors	(void)
imap_expunge	(int $imap_stream)
imap_fetch_overview	(int $imap_stream, string $sequence [, int $flags])
imap_fetchbody	(int $imap_stream, int $msg_number, string $part_number [, $flags $flags])
imap_fetchheader	(int $imap_stream, int $msgno, int $flags)
imap_fetchstructure	(int $imap_stream, int $msg_number [, int $flags])
imap_get_quota	(int $imap_stream, string $quota_root)
imap_getmailboxes	(int $imap_stream, string $ref, string $pattern)
imap_getsubscribed	(int $imap_stream, string $ref, string $pattern)
imap_header	(int $imap_stream, int $msg_number [, int $fromlength [, int $subjectlength [, string $defaulthost]]])
imap_headerinfo	(int $imap_stream, int $msg_number [, int $fromlength [, int $subjectlength [, string $defaulthost]]])
imap_headers	(int $imap_stream)
imap_last_error	(void)
imap_listmailbox	(int $imap_stream, string $ref, string $pattern)
imap_listsubscribed	(int $imap_stream, string $ref, string $pattern)
imap_mail	(string $to, string $subject, string $message [, string $additional_headers [, string $cc [, string $bcc [, string $rpath]]]])
imap_mail_compose	(array $envelope, array $body)
imap_mail_copy	(int $imap_stream, string $msglist, string $mbox [, int $flags])
imap_mail_move	(int $imap_stream, string $msglist, string $mbox [, int $flags])
imap_mime_header_decode	(string $text)
imap_msgno	(int $imap_stream, int $uid)
imap_num_msg	(int $imap_stream)
imap_num_recent	(int $imap_stream)
imap_open	(string $mailbox, string $username, string $password [, int $flags])
imap_ping	(int $imap_stream)
imap_popen	(string $mailbox, string $user, string $password [, int $options])
imap_qprint	(string string)
imap_renamemailbox	(int $imap_stream, string $old_mbox, string $new_mbox)
imap_reopen	(int $imap_stream, string $mailbox [, string $flags])
imap_rfc822_parse_adrlist	(string $address, string $default_host)
imap_rfc822_parse_headers	(string $headers [, string $defaulthost])
imap_rfc822_write_address	(string $mailbox, string $host, string $personal)
imap_scanmailbox	(int $imap_stream, string $ref, string $pattern, string $content)
imap_set_quota	(int $imap_stream, string $quota_root, int $quota_limit)
imap_setacl	(int $stream_id, string $mailbox, string $id, string $rights)
imap_setflag_full	(int $stream, string $sequence, string $flag, string $options)
imap_sort	(int $stream, int $criteria, int $reverse, int $options)
imap_status	(int $imap_stream, string $mailbox, int $options)
imap_subscribe	(int $imap_stream, string $mbox)
imap_thread	(int $stream_id [, int $flags])
imap_uid	(int $imap_stream, int $msgno)
imap_undelete	(int $imap_stream, int $msg_number)
imap_unsubscribe	(int $imap_stream, string $mbox)
imap_utf7_decode	(string $text)
imap_utf8	(string $text)
implode	(string $glue, array $pieces)
import_request_variables	(string $types [, string $prefix])
in_array	(mixed $needle, array $haystack [, $bool $strict])
info	(array $parameter)
ingres_autocommit	([resource $link])
ingres_close	([resource $link])
ingres_commit	([resource $link])
ingres_connect	([string $database [, string $username [, string $password]]])
ingres_fetch_array	([int $result_type [, resource $link]])
ingres_fetch_object	([int $result_type [, resource $link]])
ingres_field_length	(int $index [, resource $link])
ingres_field_name	(int $index [, resource $link])
ingres_field_nullable	(int $index [, resource $link])
ingres_field_precision	(int $index [, resource $link])
ingres_field_scale	(int $index [, resource $link])
ingres_field_type	(int $index [, resource $link])
ingres_num_fields	([resource $link])
ingres_num_rows	([resource $link])
ingres_pconnect	([string $database [, string $username [, string $password]]])
ingres_query	(string $query [, resource $link])
ingres_rollback	([resource $link])
ini_alter	(string $varname, string $newvalue)
ini_get	(string $varname)
ini_get_all	([string $extension])
ini_restore	(string $varname)
ini_set	(string $varname, string $newvalue)
insert	(array $parameter)
insert	(object $attribute)
insertanchor	(array $parameter)
insertcollection	(array $parameter)
insertdocument	(array $parameter)
intval	(mixed $var [, int $base])
ip2long	(string $ip_address)
iptcparse	(string $iptcblock)
ircg_channel_mode	(resource $connection, string $channel, string $mode_spec, string $nick)
ircg_disconnect	(resource $connection, string $reason)
ircg_fetch_error_msg	(resource $connection)
ircg_get_username	(int $connection)
ircg_html_encode	(string $html_string)
ircg_ignore_add	(resource $connection, string $nick)
ircg_ignore_del	(resource $connection, string $nick)
ircg_is_conn_alive	(resource $connection)
ircg_join	(resource $connection, string $channel)
ircg_kick	(resource $connection, string $channel, string $nick, string $reason)
ircg_lookup_format_messages	(string $name)
ircg_msg	(resource $connection, string $recipient, string $message [, $boolean $suppress])
ircg_nickname_escape	(string $nick)
ircg_nickname_unescape	(string $nick)
ircg_notice	(resource $connection, string $, string $message)
ircg_part	(resource $connection, string $channel)
ircg_pconnect	(string $username [, string $server_ip [, int $server_port [, string $msg_format [, array $ctcp_messages [, array $user_settings]]]]])
ircg_register_format_messages	(string $name, array $messages)
ircg_set_current	(resource $connection)
ircg_set_file	(int $connection, string $path)
ircg_set_on_die	(int $connection, string $host, int $port, string $data)
ircg_topic	(resource $connection, string $channel, string $new_topic)
ircg_whois	(resource $connection, string $nick)
is_a	(object $object, string $class_name)
is_array	(mixed $var)
is_callable	(mixed $var [, $bool $syntax_only [, string $callable_name]])
is_dir	(string $filename)
is_executable	(string $filename)
is_file	(string $filename)
is_finite	(float $val)
is_float	(mixed $var)
is_infinite	(float $val)
is_int	(mixed $var)
is_link	(string $filename)
is_nan	(float $val)
is_null	(mixed $var)
is_numeric	(mixed $var)
is_object	(mixed $var)
is_readable	(string $filename)
is_resource	(mixed $var)
is_scalar	(mixed $var)
is_string	(mixed $var)
is_subclass_of	(object $object, string $class_name)
is_uploaded_file	(string $filename)
is_writable	(string $filename)
is_writeable	(string $filename)
isset	(mixed $var [, $mixed $var [, $...]])
java_last_exception_clear	(void)
java_last_exception_get	(void)
jddayofweek	(int $julianday, int $mode)
jdmonthname	(int $julianday, int $mode)
jdtofrench	(int $juliandaycount)
jdtogregorian	(int $julianday)
jdtojewish	(int $julianday)
jdtojulian	(int $julianday)
jdtounix	(int $jday)
jewishtojd	(int $month, int $day, int $year)
join	(string $glue, array $pieces)
jpeg2wbmp	(string $jpegname, string $wbmpname, int $d_height, int $d_width, int $threshold)
juliantojd	(int $month, int $day, int $year)
key	(array array)
key	(void $)
krsort	(array $array [, int $sort_flags])
ksort	(array array [, int $sort_flags])
langdepvalue	(string $language)
lcg_value	(void)
ldap_8859_to_t61	(string $value)
ldap_add	(resource $link_identifier, string $dn, array $entry)
ldap_bind	(resource $link_identifier [, string $bind_rdn [, string $bind_password]])
ldap_close	(resource $link_identifier)
ldap_compare	(resource $link_identifier, string $dn, string $attribute, string $value)
ldap_connect	([string $hostname [, int $port]])
ldap_count_entries	(resource $link_identifier, resource $result_identifier)
ldap_delete	(resource $link_identifier, string $dn)
ldap_dn2ufn	(string $dn)
ldap_err2str	(int $errno)
ldap_errno	(resource $link_identifier)
ldap_error	(resource $link_identifier)
ldap_explode_dn	(string $dn, int $with_attrib)
ldap_first_attribute	(resource $link_identifier, resource $result_entry_identifier, int $ber_identifier)
ldap_first_entry	(resource $link_identifier, resource $result_identifier)
ldap_first_reference	(resource $link, resource $result)
ldap_free_result	(resource $result_identifier)
ldap_get_attributes	(resource $link_identifier, resource $result_entry_identifier)
ldap_get_dn	(resource $link_identifier, resource $result_entry_identifier)
ldap_get_entries	(resource $link_identifier, resource $result_identifier)
ldap_get_option	(resource $link_identifier, int $option, $mixed $retval)
ldap_get_values_len	(resource $link_identifier, resource $result_entry_identifier, string $attribute)
ldap_list	(resource $link_identifier, string $base_dn, string $filter [, array $attributes [, int $attrsonly [, int $sizelimit [, int $timelimit [, int $deref]]]]])
ldap_mod_add	(resource $link_identifier, string $dn, array $entry)
ldap_mod_del	(resource $link_identifier, string $dn, array $entry)
ldap_mod_replace	(resoure $link_identifier, string $dn, array $entry)
ldap_modify	(resource $link_identifier, string $dn, array $entry)
ldap_next_attribute	(resource $link_identifier, resource $result_entry_identifier, resource $ber_identifier)
ldap_next_entry	(resource $link_identifier, resource $result_entry_identifier)
ldap_next_reference	(resource $link, resource $entry)
ldap_parse_reference	(resource $link, resource $entry, array $referrals)
ldap_parse_result	(resource $link, resource $result, int $errcode, string $matcheddn, string $errmsg, array $referrals)
ldap_read	(resource $link_identifier, string $base_dn, string $filter [, array $attributes [, int $attrsonly [, int $sizelimit [, int $timelimit [, int $deref]]]]])
ldap_rename	(resource $link_identifier, string $dn, string $newrdn, string $newparent, $bool $deleteoldrdn)
ldap_search	(resource $link_identifier, string $base_dn, string $filter [, array $attributes [, int $attrsonly [, int $sizelimit [, int $timelimit [, int $deref]]]]])
ldap_set_rebind_proc	(resource $link, string $callback)
ldap_sort	(resource $link, resource $result, string $sortfilter)
ldap_start_tls	(resource $link)
ldap_t61_to_8859	(string $value)
ldap_unbind	(resource $link_identifier)
leak	(int $bytes)
levenshtein	(string $str1, string $str2)
levenshtein	(string $str1, string $str2, $function $cost)
levenshtein	(string $str1, string $str2, int $cost_ins, int $cost_rep, int $cost_del)
link	(array $parameter)
link	(string $target, string $link)
linkinfo	(string $path)
list	(mixed $...)
localeconv	(void)
localtime	([int $timestamp [, $bool $is_associative]])
lock	(array $parameter)
log	(float $arg)
log10	(float $arg)
log1p	(float $number)
long2ip	(int $proper_address)
lstat	(string $filename)
ltrim	(string $str [, string $charlist])
mail	(string $to, string $subject, string $message [, string $additional_headers [, string $additional_parameters ])
mailparse_determine_best_xfer_encoding	(resource $fp)
mailparse_msg_create	(void)
mailparse_msg_extract_part	(resource $rfc2045, string $msgbody [, string $callbackfunc])
mailparse_msg_extract_part_file	(resource $rfc2045, string $filename [, string $callbackfunc])
mailparse_msg_free	(resource $rfc2045buf)
mailparse_msg_get_part	(resource $rfc2045, string $mimesection)
mailparse_msg_get_part_data	(resource $rfc2045)
mailparse_msg_get_structure	(resource $rfc2045)
mailparse_msg_parse	(resource $rfc2045buf, string $data)
mailparse_msg_parse_file	(string $filename)
mailparse_rfc822_parse_addresses	(string $addresses)
mailparse_stream_encode	(resource $sourcefp, resource $destfp, string $encoding)
mailparse_uudecode_all	(resource $fp)
max	(mixed $arg1, $mixed $arg2, $mixed $argn)
mb_convert_encoding	(string $str, string $to-encoding [, $mixed $from-encoding])
mb_convert_kana	(string $str, string $option [, $mixed $encoding])
mb_convert_variables	(string $to-encoding, $mixed $from-encoding, $mixed $vars)
mb_decode_mimeheader	(string $str)
mb_decode_numericentity	(string $str, array $convmap [, string $encoding])
mb_detect_encoding	(string $str [, $mixed $encoding-list])
mb_detect_order	([mixed $encoding-list])
mb_encode_mimeheader	(string $str [, string $charset [, string $transfer-encoding [, string $linefeed]]])
mb_encode_numericentity	(string $str, array $convmap [, string $encoding])
mb_ereg	(string $pattern, string $string [, array $regs])
mb_ereg_match	(string $pattern, string $string [, string $option])
mb_ereg_replace	(string $pattern, string $replacement, string $string [, array $option])
mb_ereg_search	([string $pattern [, string $option]])
mb_ereg_search_getpos	(void)
mb_ereg_search_getregs	(void)
mb_ereg_search_init	(string string [, string $pattern [, string $option]])
mb_ereg_search_pos	([string $pattern [, string $option]])
mb_ereg_search_setpos	(void)
mb_eregi	(string $pattern, string $string [, array $regs])
mb_get_info	([string $type])
mb_http_input	([string $type])
mb_http_output	([string $encoding])
mb_internal_encoding	([string $encoding])
mb_language	([string $language])
mb_output_handler	(string $contents, int $status)
mb_parse_str	(string $encoded_string [, array $result])
mb_preferred_mime_name	(string $encoding)
mb_regex_encoding	([string $encoding])
mb_send_mail	(string $to, string $subject, string $message [, string $additional_headers [, string $additional_parameter]])
mb_strcut	(string $str, int $start [, int $length [, string $encoding]])
mb_strimwidth	(string $str, int $start, int $width, string $trimmarker [, string $encoding])
mb_strlen	(string $str [, string $encoding])
mb_strpos	(string $haystack, string $needle [, int $offset [, string $encoding]])
mb_strrpos	(string $haystack, string $needle [, string $encoding])
mb_strwidth	(string $str [, string $encoding])
mb_substitute_character	([mixed $substrchar])
mb_substr	(string $str, int $start [, int $length [, string $encoding]])
mcal_	(int $year, int $month, int $day)
mcal_append_event	(int $mcal_stream)
mcal_close	(int $mcal_stream, int $flags)
mcal_create_calendar	(int $stream, string $calendar)
mcal_date_compare	(int $a_year, int $a_month, int $a_day, int $b_year, int $b_month, int $b_day)
mcal_date_valid	(int $year, int $month, int $day)
mcal_day_of_week	(int $year, int $month, int $day)
mcal_days_in_month	(int $month, int $leap $year)
mcal_delete_calendar	(int $stream, string $calendar)
mcal_delete_event	(int $mcal_stream [, int $event_id])
mcal_event_add_attribute	(int $stream, string $attribute, string $value)
mcal_event_init	(int $stream)
mcal_event_set_alarm	(int $stream, int $alarm)
mcal_event_set_category	(int $stream, string $category)
mcal_event_set_class	(int $stream, int $class)
mcal_event_set_description	(int $stream, string $description)
mcal_event_set_end	(int $stream, int $year, int $month [, int $day [, int $hour [, int $min [, int $sec]]]])
mcal_event_set_recur_daily	(int $stream, int $year, int $month, int $day, int $interval)
mcal_event_set_recur_monthly_mday	(int $stream, int $year, int $month, int $day, int $interval)
mcal_event_set_recur_monthly_wday	(int $stream, int $year, int $month, int $day, int $interval)
mcal_event_set_recur_none	(int $stream)
mcal_event_set_recur_weekly	(int $stream, int $year, int $month, int $day, int $interval, int $weekdays)
mcal_event_set_recur_yearly	(int $stream, int $year, int $month, int $day, int $interval)
mcal_event_set_start	(int $stream, int $year, int $month [, int $day [, int $hour [, int $min [, int $sec]]]])
mcal_event_set_title	(int $stream, string $title)
mcal_expunge	(int $stream)
mcal_fetch_current_stream_event	(int $stream)
mcal_fetch_event	(int $mcal_stream, int $event_id [, int $options])
mcal_is_leap_year	(int $year)
mcal_list_alarms	(int $mcal_stream [, int $begin_year [, int $begin_month [, int $begin_day [, int $end_year [, int $end_month [, int $end_day]]]]]])
mcal_list_events	(int $mcal_stream, $object $begin_date [, $object $end_date])
mcal_next_recurrence	(int $stream, int $weekstart, array $next)
mcal_open	(string $calendar, string $username, string $password [, int $options])
mcal_popen	(string $calendar, string $username, string $password [, int $options])
mcal_rename_calendar	(int $stream, string $old_name, string $new_name)
mcal_reopen	(string $calendar [, int $options])
mcal_snooze	(int $id)
mcal_store_event	(int $mcal_stream)
mcal_time_valid	(int $hour, int $minutes, int $seconds)
mcal_week_of_year	(int $day, int $month, int $year)
mcrypt_cbc	(int $cipher, string $key, string $data, int $mode [, string $iv])
mcrypt_cbc	(string $cipher, string $key, string $data, int $mode [, string $iv])
mcrypt_cfb	(int $cipher, string $key, string $data, int $mode, string $iv)
mcrypt_cfb	(string $cipher, string $key, string $data, int $mode [, string $iv])
mcrypt_create_iv	(int $size, int $source)
mcrypt_ecb	(int $cipher, string $key, string $data, int $mode)
mcrypt_ecb	(string $cipher, string $key, string $data, int $mode [, string $iv])
mcrypt_enc_get_algorithms_name	(resource $td)
mcrypt_enc_get_block_size	(resource $td)
mcrypt_enc_get_iv_size	(resource $td)
mcrypt_enc_get_key_size	(resource $td)
mcrypt_enc_get_modes_name	(resource $td)
mcrypt_enc_get_supported_key_sizes	(resource $td)
mcrypt_enc_is_block_algorithm	(resource $td)
mcrypt_enc_is_block_algorithm_mode	(resource $td)
mcrypt_enc_is_block_mode	(resource $td)
mcrypt_enc_self_test	(resource $td)
mcrypt_encrypt	(string $cipher, string $key, string $data, string $mode [, string $iv])
mcrypt_generic	(resource $td, string $data)
mcrypt_generic_deinit	(resource $td)
mcrypt_generic_end	(resource $td)
mcrypt_generic_init	(resource $td, string $key, string $iv)
mcrypt_get_block_size	(int $cipher)
mcrypt_get_block_size	(string $cipher, string $module)
mcrypt_get_cipher_name	(int $cipher)
mcrypt_get_cipher_name	(string $cipher)
mcrypt_get_iv_size	(resource $td)
mcrypt_get_iv_size	(string $cipher, string $mode)
mcrypt_get_key_size	(int $cipher)
mcrypt_get_key_size	(string $cipher, string $module)
mcrypt_list_modes	([string $lib_dir])
mcrypt_module_close	(resource $td)
mcrypt_module_get_algo_block_size	(string $algorithm [, string $lib_dir])
mcrypt_module_get_algo_key_size	(string $algorithm [, string $lib_dir])
mcrypt_module_get_supported_key_sizes	(string $algorithm [, string $lib_dir])
mcrypt_module_is_block_algorithm	(string $algorithm [, string $lib_dir])
mcrypt_module_is_block_algorithm_mode	(string $mode [, string $lib_dir])
mcrypt_module_is_block_mode	(string $mode [, string $lib_dir])
mcrypt_module_open	(string $algorithm, string $algorithm_directory, string $mode, string $mode_directory)
mcrypt_module_self_test	(string $algorithm [, string $lib_dir])
mcrypt_ofb	(int $cipher, string $key, string $data, int $mode, string $iv)
mcrypt_ofb	(string $cipher, string $key, string $data, int $mode [, string $iv])
md5	(string $str)
md5_file	(string $filename)
mdecrypt_generic	(resource $td, string $data)
metaphone	(string $str)
method_exists	(object $object, string $method_name)
mhash	(int $hash, string $data [, string $key])
mhash_count	(void)
mhash_get_block_size	(int $hash)
mhash_get_hash_name	(int $hash)
mhash_keygen_s2k	(int $hash, string $password, string $salt, int $bytes)
microtime	(void)
min	(array $numbers)
ming_setcubicthreshold	(int $threshold)
ming_setscale	(int $scale)
ming_useswfversion	(int $version)
mkdir	(string $pathname, int $mode)
mktime	(int $hour, int $minute, int $second, int $month, int $day, int $year [, int $is_dst])
move	(array $parameter)
move_uploaded_file	(string $filename, string $destination)
msession_connect	(string $host, string $port)
msession_count	(void)
msession_create	(string $session)
msession_destroy	(string $name)
msession_disconnect	(void)
msession_find	(string $name, string $value)
msession_get	(string $session, string $name, string $value)
msession_get_array	(string $session)
msession_getdata	(string $session)
msession_inc	(string $session, string $name)
msession_list	(void)
msession_listvar	(string $name)
msession_lock	(string $name)
msession_plugin	(string $session, string $val [, string $param])
msession_randstr	(int $param)
msession_set	(string $session, string $name, string $value)
msession_set_array	(string $session, array $tuples)
msession_setdata	(string $session, string $value)
msession_timeout	(string $session [, int $param])
msession_uniq	(int $param)
msession_unlock	(string $session, int $key)
msql	(string $database, string $query, int $link_identifier)
msql_close	(int $link_identifier)
msql_connect	([string $hostname [, string $server [, string $username [, string $password]]]])
msql_create_db	(string $database $name [, int $link_identifier])
msql_createdb	(string $database $name [, int $link_identifier])
msql_data_seek	(int $query_identifier, int $row_number)
msql_dbname	(int $query_identifier, int $i)
msql_drop_db	(string $database_name, int $link_identifier)
msql_error	([int $link_identifier])
msql_fetch_array	(int $query_identifier [, int $result_type])
msql_fetch_field	(int $query_identifier, int $field_offset)
msql_fetch_object	(int $query_identifier [, int $result_type])
msql_fetch_row	(int $query_identifier)
msql_field_seek	(int $query_identifier, int $field_offset)
msql_fieldflags	(int $query_identifier, int $i)
msql_fieldlen	(int $query_identifier, int $i)
msql_fieldname	(int $query_identifier, int $field)
msql_fieldtable	(int $query_identifier, int $field)
msql_fieldtype	(int $query_identifier, int $i)
msql_free_result	(int $query_identifier)
msql_list_dbs	(void)
msql_list_fields	(string $database, string $tablename)
msql_list_tables	(string $database)
msql_num_fields	(int $query_identifier)
msql_num_rows	(int $query_identifier)
msql_numfields	(int $query_identifier)
msql_numrows	(void)
msql_pconnect	([string $server [, string $username [, string $password]]])
msql_query	(string $query, int $link_identifier)
msql_result	(int $query_identifier, int $i, $mixed $field)
msql_select_db	(string $database_name, int $link_identifier)
msql_tablename	(int $query_identifier, int $field)
mssql_close	([int $link_identifier])
mssql_connect	([string $servername [, string $username [, string $password]]])
mssql_data_seek	(int $result_identifier, int $row_number)
mssql_execute	(int $stmt)
mssql_fetch_array	(int $result)
mssql_fetch_assoc	(int $result_id [, int $result_type])
mssql_fetch_batch	(string $result_index)
mssql_fetch_field	(int $result [, int $field_offset])
mssql_fetch_object	(int $result)
mssql_fetch_row	(int $result)
mssql_field_length	(int $result [, int $offset])
mssql_field_name	(int $result [, int $offset])
mssql_field_seek	(int $result, int $field_offset)
mssql_field_type	(int $result [, int $offset])
mssql_free_result	(int $result)
mssql_get_last_message	(void)
mssql_guid_string	(string $binary [, int $short_format])
mssql_init	(string $sp_name [, int $conn_id])
mssql_min_error_severity	(int $severity)
mssql_min_message_severity	(int $severity)
mssql_next_result	(int $result_id)
mssql_num_fields	(int $result)
mssql_num_rows	(string $result)
mssql_pconnect	([string $servername [, string $username [, string $password]]])
mssql_query	(string $query [, int $link_identifier])
mssql_result	(int $result, int $i, $mixed $field)
mssql_rows_affected	(int $conn_id)
mssql_select_db	(string $database_name [, int $link_identifier])
mt_getrandmax	(void)
mt_rand	([int $min, int $max])
mt_srand	(int $seed)
muscat_get	(resource $muscat_handle)
muscat_give	(resource $muscat_handle, string $string)
muscat_setup	(int $size [, string $muscat_dir])
muscat_setup_net	(string $muscat_host, int $port)
mysql_affected_rows	([resource $link_identifier])
mysql_change_user	(string $user, string $password [, string $database [, resource $link_identifier]])
mysql_character_set_name	([resource $link_identifier])
mysql_close	([resource $link_identifier])
mysql_connect	(string $server [, string $username [, string $password ]])
mysql_create_db	(string $database $name [, resource $link_identifier])
mysql_data_seek	(resource $result_identifier, int $row_number)
mysql_db_name	(resource $result, int $row [, $mixed $field])
mysql_db_query	(string $database, string $query [, resource $link_identifier])
mysql_drop_db	(string $database_name [, resource $link_identifier])
mysql_errno	([resource $link_identifier])
mysql_error	([resource $link_identifier])
mysql_escape_string	(string $unescaped_string)
mysql_fetch_array	(resource $result [, int $result_type])
mysql_fetch_assoc	(resource $result)
mysql_fetch_field	(resource $result [, int $field_offset])
mysql_fetch_lengths	(resource $result)
mysql_fetch_object	(resource $result)
mysql_fetch_row	(resource $result)
mysql_field_flags	(resource $result, int $field_offset)
mysql_field_len	(resource $result, int $field_offset)
mysql_field_name	(resource $result, int $field_index)
mysql_field_table	(resource $result, int $field_offset)
mysql_field_type	(iresource $result, int $field_offset)
mysql_free_result	(resource $result)
mysql_get_client_info	(void)
mysql_get_host_info	([resource $link_identifier])
mysql_get_proto_info	([resource $link_identifier])
mysql_get_server_info	([resource $link_identifier])
mysql_info	([resource $link_identifier])
mysql_list_dbs	([resource $link_identifier])
mysql_list_processes	([resource $link_identifier])
mysql_list_tables	(string $database [, resource $link_identifier])
mysql_num_fields	(resource $result)
mysql_num_rows	(resource $result)
mysql_pconnect	([string $server [, string $username [, string $password]]])
mysql_ping	([resource $link_identifier])
mysql_query	(string $query [, resource $link_identifier [, int $result_mode]])
mysql_real_escape_string	(string $unescaped_string [, resource $link_identifier])
mysql_result	(resource $result, int $row [, $mixed $field])
mysql_select_db	(string $database_name [, resource $link_identifier])
mysql_stat	([resource $link_identifier])
mysql_tablename	(resource $result, int $i)
mysql_thread_id	([resource $link_identifier])
mysql_unbuffered_query	(string $query [, resource $link_identifier [, int $result_mode]])
natcasesort	(array array)
natsort	(array $array)
ncurses_addch	(int $ch)
ncurses_addchnstr	(string $s, int $n)
ncurses_addchstr	(string $s)
ncurses_addnstr	(string $s, int $n)
ncurses_addstr	(string $text)
ncurses_assume_default_colors	(int $fg, int $bg)
ncurses_attroff	(int $attributes)
ncurses_attron	(int $attributes)
ncurses_attrset	(int $attributes)
ncurses_baudrate	(void)
ncurses_beep	(void)
ncurses_bkgd	(int $attrchar)
ncurses_bkgdset	(int $attrchar)
ncurses_border	(int $left, int $right, int $top, int $bottom, int $tl_corner, int $tr_corner, int $bl_corner, int $br_corner)
ncurses_can_change_color	(void)
ncurses_cbreak	(void)
ncurses_clear	(void)
ncurses_clrtobot	(void)
ncurses_clrtoeol	(void)
ncurses_color_set	(int $pair)
ncurses_curs_set	(int $visibility)
ncurses_def_prog_mode	(void)
ncurses_def_shell_mode	(void)
ncurses_define_key	(string $definition, int $keycode)
ncurses_delay_output	(int $milliseconds)
ncurses_delch	(void)
ncurses_deleteln	(void)
ncurses_delwin	(resource $window)
ncurses_doupdate	(void)
ncurses_echo	(void)
ncurses_echochar	(int $character)
ncurses_end	(void)
ncurses_erase	(void)
ncurses_erasechar	(void)
ncurses_flash	(void)
ncurses_flushinp	(void)
ncurses_getch	(void)
ncurses_getmouse	(array $mevent)
ncurses_halfdelay	(int $tenth)
ncurses_has_colors	(void)
ncurses_has_ic	(void)
ncurses_has_il	(void)
ncurses_has_key	(int $keycode)
ncurses_hline	(int $charattr, int $n)
ncurses_inch	(void)
ncurses_init	(void)
ncurses_init_color	(int $color, int $r, int $g, int $b)
ncurses_init_pair	(int $pair, int $fg, int $bg)
ncurses_insch	(int $character)
ncurses_insdelln	(int $count)
ncurses_insertln	(void)
ncurses_instr	(string $buffer)
ncurses_isendwin	(void)
ncurses_keyok	(int $keycode, $bool $enable)
ncurses_killchar	(void)
ncurses_longname	(void)
ncurses_mouseinterval	(int $milliseconds)
ncurses_mousemask	(int $newmask, int $oldmask)
ncurses_move	(int $y, int $x)
ncurses_mvaddch	(int $y, int $x, int $c)
ncurses_mvaddchnstr	(int $y, int $x, string $s, int $n)
ncurses_mvaddchstr	(int $y, int $x, string $s)
ncurses_mvaddnstr	(int $y, int $x, string $s, int $n)
ncurses_mvaddstr	(int $y, int $x, string $s)
ncurses_mvcur	(int $old_y, int $old_x, int $new_y, int $new_x)
ncurses_mvdelch	(int $y, int $x)
ncurses_mvgetch	(int $y, int $x)
ncurses_mvhline	(int $y, int $x, int $attrchar, int $n)
ncurses_mvinch	(int $y, int $x)
ncurses_mvvline	(int $y, int $x, int $attrchar, int $n)
ncurses_mvwaddstr	(resource $window, int $y, int $x, string $text)
ncurses_napms	(int $milliseconds)
ncurses_newwin	(int $rows, int $cols, int $y, int $x)
ncurses_nl	(void)
ncurses_nocbreak	(void)
ncurses_noecho	(void)
ncurses_nonl	(void)
ncurses_noqiflush	(void)
ncurses_noraw	(void)
ncurses_putp	(string $text)
ncurses_qiflush	(void)
ncurses_raw	(void)
ncurses_refresh	(int $ch)
ncurses_resetty	(void)
ncurses_savetty	(void)
ncurses_scr_dump	(string $filename)
ncurses_scr_init	(string $filename)
ncurses_scr_restore	(string $filename)
ncurses_scr_set	(string $filename)
ncurses_scrl	(int $count)
ncurses_slk_attr	(void)
ncurses_slk_attron	(int $intarg)
ncurses_slk_attrset	(int $intarg)
ncurses_slk_clear	(void)
ncurses_slk_color	(int $intarg)
ncurses_slk_init	(int $format)
ncurses_slk_noutrefresh	(void)
ncurses_slk_refresh	(void)
ncurses_slk_restore	(void)
ncurses_slk_touch	(void)
ncurses_standend	(void)
ncurses_standout	(void)
ncurses_start_color	(void)
ncurses_termattrs	(void)
ncurses_termname	(void)
ncurses_timeout	(int $millisec)
ncurses_typeahead	(int $fd)
ncurses_ungetch	(int $keycode)
ncurses_ungetmouse	(array $mevent)
ncurses_use_default_colors	(void)
ncurses_use_env	(bool $flag)
ncurses_use_extended_names	(bool $flag)
ncurses_vidattr	(int $intarg)
ncurses_vline	(int $charattr, int $n)
ncurses_wrefresh	(resource $window)
next	(array array)
ngettext	(string $msgid1, string $msgid2, int $n)
nl2br	(string string)
notes_body	(string $server, string $mailbox, int $msg_number)
notes_copy_db	(string $from_database_name, string $to_database_name)
notes_create_db	(string $database_name)
notes_create_note	(string $database_name, string $form_name)
notes_drop_db	(string $database_name)
notes_find_note	(string $database_name, string $name [, string $type])
notes_header_info	(string $server, string $mailbox, int $msg_number)
notes_list_msgs	(string $db)
notes_mark_read	(string $database_name, string $user_name, string $note_id)
notes_mark_unread	(string $database_name, string $user_name, string $note_id)
notes_nav_create	(string $database_name, string $name)
notes_search	(string $database_name, string $keywords)
notes_unread	(string $database_name, string $user_name)
notes_version	(string $database_name)
number_format	(float $number [, int $decimals [, string $dec_point [, string $thousands_sep]]])
ob_clean	(void)
ob_end_clean	(void)
ob_end_flush	(void)
ob_flush	(void)
ob_get_contents	(void)
ob_get_length	(void)
ob_get_level	(void)
ob_gzhandler	(string $buffer [, int $mode])
ob_iconv_handler	(string $contents, int $status)
ob_implicit_flush	([int $flag])
ob_start	([string $output_callback])
objectbyanchor	(array $parameter)
OCIBindByName	(int $stmt, string $ph_name, $mixed &$variable, int $length [, int $type])
OCICancel	(int $stmt)
OCICollAppend	(object $collection, $object $object)
OCICollAssign	(object $collection, $object $object)
OCICollAssignElem	(object $collection, string $ndx, string $val)
OCICollGetElem	(object $collection, string $ndx)
OCICollMax	(object $collection)
OCICollSize	(object $collection)
OCICollTrim	(object $collection, int $num)
OCIColumnIsNULL	(int $stmt, $mixed $column)
OCIColumnName	(int $stmt, int $col)
OCIColumnScale	(int $stmt, int $col)
OCIColumnSize	(int $stmt, $mixed $column)
OCIColumnType	(int $stmt, int $col)
OCICommit	(int $connection)
OCIDefineByName	(int $stmt, string $Column-Name, $mixed $variable [, int $type])
OCIError	([int $stmt|conn|global])
OCIExecute	(int $statement [, int $mode])
OCIFetch	(int $statement)
OCIFetchInto	(int $stmt, array &$result [, int $mode])
OCIFetchStatement	(int $stmt, array &$variable)
OCIFreeCollection	(object $lob)
OCIFreeCursor	(int $stmt)
OCIFreeDesc	(object $lob)
OCIFreeStatement	(int $stmt)
OCIInternalDebug	(int $onoff)
OCILoadLob	(object $lob)
OCILogOff	(int $connection)
OCILogon	(string $username, string $password [, string $db])
OCINewCollection	(int $conn, string $tdo [, string $shema])
OCINewCursor	(int $conn)
OCINewDescriptor	(int $connection [, int $type])
OCINLogon	(string $username, string $password [, string $db])
OCINumCols	(int $stmt)
OCIParse	(int $conn, string $query)
OCIPLogon	(string $username, string $password [, string $db])
OCIResult	(int $statement, $mixed $column)
OCIRollback	(int $connection)
OCIRowCount	(int $statement)
OCISaveLob	(object $lob)
OCISaveLobFile	(object $lob)
OCIServerVersion	(int $conn)
OCISetPrefetch	(int $stmt, int $rows)
OCIStatementType	(int $stmt)
OCIWriteLobToFile	(object $lob [, string $filename [, int $start [, int $lenght]]])
octdec	(string $octal_string)
odbc_autocommit	(resource $connection_id [, $bool $OnOff])
odbc_binmode	(resource $result_id, int $mode)
odbc_close	(resource $connection_id)
odbc_close_all	(void)
odbc_columnprivileges	(resource $connection_id [, string $qualifier [, string $owner [, string $table_name [, string $column_name]]]])
odbc_columns	(resource $connection_id [, string $qualifier [, string $owner [, string $table_name [, string $column_name]]]])
odbc_commit	(resource $connection_id)
odbc_connect	(string $dsn, string $user, string $password [, int $cursor_type])
odbc_cursor	(resource $result_id)
odbc_do	(resource $conn_id, string $query)
odbc_error	([resource $connection_id])
odbc_errormsg	([resource $connection_id])
odbc_exec	(resource $connection_id, string $query_string)
odbc_execute	(resource $result_id [, array $parameters_array])
odbc_fetch_array	(resource $result [, int $rownumber])
odbc_fetch_into	(resource $result_id [, int $rownumber, array $result_array])
odbc_fetch_into	(resource $result_id, array $result_array [, int $rownumber])
odbc_fetch_object	(resource $result [, int $rownumber])
odbc_fetch_row	(resource $result_id [, int $row_number])
odbc_field_len	(resource $result_id, int $field_number)
odbc_field_name	(resource $result_id, int $field_number)
odbc_field_num	(resource $result_id, string $field_name)
odbc_field_precision	(resource $result_id, int $field_number)
odbc_field_scale	(resource $result_id, int $field_number)
odbc_field_type	(resource $result_id, int $field_number)
odbc_foreignkeys	(resource $connection_id, string $pk_qualifier, string $pk_owner, string $pk_table, string $fk_qualifier, string $fk_owner, string $fk_table)
odbc_free_result	(resource $result_id)
odbc_gettypeinfo	(resource $connection_id [, int $data_type])
odbc_longreadlen	(resource $result_id, int $length)
odbc_next_result	(resource $result_id)
odbc_num_fields	(resource $result_id)
odbc_num_rows	(resource $result_id)
odbc_pconnect	(string $dsn, string $user, string $password [, int $cursor_type])
odbc_prepare	(resource $connection_id, string $query_string)
odbc_primarykeys	(resource $connection_id, string $qualifier, string $owner, string $table)
odbc_procedurecolumns	(resource $connection_id [, string $qualifier [, string $owner [, string $proc [, string $column]]]])
odbc_procedures	(resource $connection_id [, string $qualifier [, string $owner [, string $name]]])
odbc_result	(resource $result_id, $mixed $field)
odbc_result_all	(resource $result_id [, string $format])
odbc_rollback	(resource $connection_id)
odbc_setoption	(resource $id, int $function, int $option, int $param)
odbc_statistics	(resource $connection_id, string $qualifier, string $owner, string $table_name, int $unique, int $accuracy)
odbc_tableprivileges	(resource $connection_id [, string $qualifier [, string $owner [, string $name]]])
odbc_tables	(resource $connection_id [, string $qualifier [, string $owner [, string $name [, string $types]]]])
opendir	(string $path)
openlog	(string $ident, int $option, int $facility)
openssl_csr_export	(resource $csr, string $out [, $bool $notext])
openssl_csr_export_to_file	(resource $csr, string $outfilename [, $bool $notext])
openssl_csr_new	(array $dn, resource $privkey [, array $extraattribs [, array $configargs]])
openssl_csr_sign	(mixed $csr, $mixed $x509, $mixed $priv_key, $long $days)
openssl_error_string	(void)
openssl_get_publickey	(mixed $certificate)
openssl_open	(string $sealed_data, string $open_data, string $env_key, $mixed $priv_key_id)
openssl_pkcs7_decrypt	(string $infilename, string $outfilename, $mixed $recipcert, $mixed $recipkey)
openssl_pkcs7_encrypt	(string $infilename, string $outfilename, $mixed $recipcerts, array $headers [, $long $flags])
openssl_pkcs7_verify	(string $filename, int $flags [, string $outfilename [, array $cainfo [, string $extracerts]]])
openssl_pkey_export	(mixed $key, $mixed $out [, string $passphrase [, array $config_args]])
openssl_pkey_export_to_file	(mixed $key, string $outfilename [, string $passphrase [, array $config_args]])
openssl_pkey_new	([array $configargs])
openssl_private_decrypt	(string $data, string $crypted, $mixed $key [, int $padding])
openssl_private_encrypt	(string $data, string $crypted, $mixed $key [, int $padding])
openssl_public_decrypt	(string $data, string $crypted, resource $key [, int $padding])
openssl_public_encrypt	(string $data, string $crypted, $mixed $key [, int $padding])
openssl_seal	(string $data, string $sealed_data, array $env_keys, array $pub_key_ids)
openssl_sign	(string $data, string $signature, $mixed $priv_key_id)
openssl_verify	(string $data, string $signature, $mixed $pub_key_id)
openssl_x509_check_private_key	(mixed $cert, $mixed $key)
openssl_x509_checkpurpose	(mixed $x509cert, int $purpose, array $cainfo [, string $untrustedfile])
openssl_x509_export	(mixed $x509, string $outfilename [, $bool $notext])
openssl_x509_export_to_file	(mixed $x509, string $outfilename [, $bool $notext])
openssl_x509_free	(resource $x509cert)
openssl_x509_parse	(mixed $x509cert [, $bool $shortnames])
openssl_x509_read	(mixed $x509certdata)
ora_bind	(int $cursor, string $PHP $variable $name, string $SQL $parameter $name, int $length [, int $type])
Ora_ColumnName	(int $cursor, int $column)
Ora_ColumnSize	(int $cursor, int $column)
Ora_ColumnType	(int $cursor, int $column)
ora_commit	(int $conn)
ora_commitoff	(int $conn)
ora_commiton	(int $conn)
ora_do	(int $conn, string $query)
Ora_Error	(int $cursor_or_connection)
Ora_ErrorCode	(int $cursor_or_connection)
ora_exec	(int $cursor)
ora_fetch	(int $cursor)
ora_fetch_into	(int $cursor, array $result [, int $flags])
ora_getcolumn	(int $cursor, $mixed $column)
ora_logoff	(int $connection)
ora_logon	(string $user, string $password)
ora_numcols	(int $cursor_ind)
ora_numrows	(int $cursor_ind)
ora_open	(int $connection)
ora_parse	(int $cursor_ind, string $sql_statement, int $defer)
ora_plogon	(string $user, string $password)
ora_rollback	(int $connection)
ord	(string $string)
overload	([string $class_name])
ovrimos_close	(int $connection)
ovrimos_commit	(int $connection_id)
ovrimos_connect	(string $host, string $db, string $user, string $password)
ovrimos_cursor	(int $result_id)
ovrimos_exec	(int $connection_id, string $query)
ovrimos_execute	(int $result_id [, array $parameters_array])
ovrimos_fetch_row	(int $result_id [, int $how [, int $row_number]])
ovrimos_field_name	(int $result_id, int $field_number)
ovrimos_field_num	(int $result_id, string $field_name)
ovrimos_field_type	(int $result_id, int $field_number)
ovrimos_free_result	(int $result_id)
ovrimos_longreadlen	(int $result_id, int $length)
ovrimos_num_fields	(int $result_id)
ovrimos_num_rows	(int $result_id)
ovrimos_prepare	(int $connection_id, string $query)
ovrimos_result	(int $result_id, $mixed $field)
ovrimos_result_all	(int $result_id [, string $format])
ovrimos_rollback	(int $connection_id)
pack	(string $format [, $mixed $args])
parents	(array $parameter)
parse_ini_file	(string $filename [, $bool $process_sections])
parse_str	(string $str [, array $arr])
parse_url	(string $url)
passthru	(string $command [, int $return_var])
pathinfo	(string $path)
pclose	(int $fp)
pcntl_exec	(string $path [, array $args [, array $envs]])
pcntl_fork	(void)
pcntl_signal	(int $signo, $mixed $handle)
pcntl_waitpid	(int $pid, int $status, int $options)
pcntl_wexitstatus	(int $status)
pcntl_wifexited	(int $status)
pcntl_wifstopped	(int $status)
pcntl_wtermsig	(int $status)
pdf_add_bookmark	(int $pdf $object, string $text [, int $parent [, int $open]])
pdf_add_launchlink	(int $pdf $object, $float $llx, $float $lly, $float $urx, $float $ury, string $filename)
pdf_add_locallink	(int $pdf $object, $float $llx, $float $lly, $float $urx, $float $ury, int $page, string $dest)
pdf_add_note	(int $pdf $object, $float $llx, $float $lly, $float $urx, $float $ury, string $contents, string $title, string $icon, int $open)
pdf_add_thumbnail	(int $pdf $object, int $image)
pdf_add_weblink	(int $pdf $object, $float $llx, $float $lly, $float $urx, $float $ury, string $url)
pdf_arc	(resource $pdf $object, $float $x, $float $y, $float $r, $float $alpha, $float $beta)
pdf_arc	(resource $pdf $object, $float $x, $float $y, $float $r, $float $alpha, $float $beta)
pdf_attach_file	(int $pdf $object, $float $llx, $float $lly, $float $urx, $float $ury, string $filename, string $description, string $author, string $mimetype, string $icon)
pdf_begin_page	(int $pdf $object, $float $width, $float $height)
pdf_begin_pattern	(int $pdf $object, $float $width, $float $height, $float $xstep, $float $ystep, int $painttype)
pdf_begin_template	(int $pdf $object, $float $width, $float $height)
pdf_circle	(int $pdf $object, $float $x, $float $y, $float $r)
pdf_clip	(int $pdf $object)
pdf_close	(int $pdf $object)
pdf_close_image	(int $pdf $object, int $image)
pdf_close_pdi	(int $pdf $object, int $dochandle)
pdf_close_pdi_page	(int $pdf $object, int $pagehandle)
pdf_closepath	(int $pdf $object)
pdf_closepath_fill_stroke	(int $pdf $object)
pdf_closepath_stroke	(int $pdf $object)
pdf_concat	(int $pdf $object, $float $a, $float $b, $float $c, $float $d, $float $e, $float $f)
pdf_continue_text	(int $pdf $object, string $text)
pdf_curveto	(int $pdf $object, $float $x1, $float $y1, $float $x2, $float $y2, $float $x3, $float $y3)
pdf_delete	(int $pdf $object)
pdf_end_page	(int $pdf $object)
pdf_end_pattern	(int $pdf $object)
pdf_end_template	(int $pdf $object)
pdf_fill_stroke	(int $pdf $object)
pdf_fill_stroke	(int $pdf $object)
pdf_findfont	(int $pdf $object, string $fontname, string $encoding, int $embed)
pdf_get_buffer	(int $pdf $object)
pdf_get_image_height	(int $pdf $object, int $image)
pdf_get_image_width	(int $pdf $object, int $image)
pdf_get_majorversion	(void)
pdf_get_majorversion	(void)
pdf_get_parameter	(int $pdf $object, string $key [, $float $modifier])
pdf_get_pdi_parameter	(int $pdf $object, string $key, int $doc, int $page, int $index)
pdf_get_pdi_value	(int $pdf $object, string $key, int $doc, int $page, int $index)
pdf_get_value	(int $pdf $object, string $key [, $float $modifier])
pdf_initgraphics	(int $pdf $object)
pdf_lineto	(int $pdf $object, $float $x, $float $y)
pdf_makespotcolor	(int $pdf $object, string $spotname)
pdf_moveto	(int $pdf $object, $float $x, $float $y)
pdf_new	()
pdf_open_CCITT	(int $pdf $object, string $filename, int $width, int $height, int $BitReverse, int $k, int $Blackls1)
pdf_open_file	(int $pdf $object [, string $filename])
pdf_open_image_file	(int $PDF-document, string $imagetype, string $filename [, string $stringparam [, string $intparam]])
pdf_open_memory_image	(int $pdf $object, int $image)
pdf_open_pdi	(int $pdf $object, string $filename, string $stringparam, int $intparam)
pdf_open_pdi_page	(int $pdf $object, int $dochandle, int $pagenumber, string $pagelabel)
pdf_open_tiff	(int $PDF-document, string $filename)
pdf_place_image	(int $pdf $object, int $image, $float $x, $float $y, $float $scale)
pdf_place_pdi_page	(int $pdf $object, int $page, $float $x, $float $y, $float $sx, $float $sy)
pdf_rect	(int $pdf $object, $float $x, $float $y, $float $width, $float $height)
pdf_restore	(int $pdf $object)
pdf_rotate	(int $pdf $object, $float $phi)
pdf_save	(int $pdf $object)
pdf_scale	(int $pdf $object, $float $x-scale, $float $y-scale)
pdf_set_border_color	(int $pdf $object, $float $red, $float $green, $float $blue)
pdf_set_border_dash	(int $pdf $object, $float $black, $float $white)
pdf_set_border_style	(int $pdf $object, string $style, $float $width)
pdf_set_horiz_scaling	(int $pdf $object, $float $scale)
pdf_set_info	(int $pdf $object, string $key, string $value)
pdf_set_info_author	(int $pdfdoc, string $author)
pdf_set_info_creator	(int $pdfdoc, string $creator)
pdf_set_info_keywords	(int $pdfdoc, string $keywords)
pdf_set_info_subject	(int $pdfdoc, string $subject)
pdf_set_info_title	(int $pdfdoc, string $title)
pdf_set_parameter	(int $pdf $object, string $key, string $value)
pdf_set_text_pos	(int $pdf $object, $float $x, $float $y)
pdf_set_value	(int $pdf $object, string $key, $float $value)
pdf_setcolor	(int $pdf $object, string $type, string $colorspace, $float $c1 [, $float $c2 [, $float $c3 [, $float $c4]]])
pdf_setflat	(int $pdf $object, $float $flatness)
pdf_setfont	(int $pdf $object, int $font, $float $size)
pdf_setgray	(int $pdf $object, $float $gray)
pdf_setgray_fill	(int $pdf $object, $float $gray)
pdf_setgray_stroke	(int $pdf $object, $float $gray)
pdf_setlinecap	(int $pdf $object, int $linecap)
pdf_setlinejoin	(int $pdf $object, $long $linejoin)
pdf_setlinewidth	(int $pdf $object, $float $width)
pdf_setmatrix	(int $pdf $object, $float $a, $float $b, $float $c, $float $d, $float $e, $float $f)
pdf_setmiterlimit	(int $pdf $object, $float $miter)
pdf_setpolydash	(int $pdf $object, $float $* $dasharray)
pdf_setrgbcolor	(int $pdf $object, $float $red $value, $float $green $value, $float $blue $value)
pdf_setrgbcolor_fill	(int $pdf $object, $float $red $value, $float $green $value, $float $blue $value)
pdf_setrgbcolor_stroke	(int $pdf $object, $float $red $value, $float $green $value, $float $blue $value)
pdf_show	(int $pdf $object, string $text)
pdf_show_boxed	(int $pdf $object, string $text, $float $left, $float $top, $float $width, $float $height, string $hmode [, string $feature])
pdf_skew	(int $pdf $object, $float $alpha, $float $beta)
pdf_stringwidth	(int $pdf $object, string $text [, int $font [, $float $size]])
pdf_stroke	(int $pdf $object)
pdf_translate	(int $pdf $object, $float $tx, $float $ty)
pfpro_cleanup	(void)
pfpro_init	(void)
pfpro_process	(array $parameters [, string $address [, int $port [, int $timeout [, string $proxy $address [, int $proxy $port [, string $proxy $logon [, string $proxy $password]]]]]]])
pfpro_version	(void)
pfsockopen	(string $hostname, int $port [, int $errno [, string $errstr [, int $timeout]]])
pg_cancel_query	(resource $connection)
pg_client_encoding	([resource $connection])
pg_close	(resource $connection)
pg_connect	(string $connection_string)
pg_connection_busy	(resource $connection)
pg_connection_reset	(resource $connection)
pg_connection_status	(resource $connection)
pg_convert	(resource $connection, string $table_name, array $assoc_array)
pg_copy_from	(int $connection, string $table_name, array $rows [, string $delimiter [, string $null_as]])
pg_copy_to	(int $connection, string $table_name [, string $delimiter [, string $null_as]])
pg_dbname	(resource $connection)
pg_delete	(resource $connection, string $table_name, array $assoc_array [, $bool $convert])
pg_end_copy	([resource $connection])
pg_escape_bytea	(string $data)
pg_escape_string	(string $data)
pg_fetch_array	(resource $result, int $row [, int $result_type])
pg_fetch_object	(resource $result, int $row [, int $result_type])
pg_fetch_result	(resource $result, int $row_number, $mixed $field)
pg_fetch_row	(resource $result, int $row)
pg_field_is_null	(resource $result, int $row, $mixed $field)
pg_field_name	(resource $result, int $field_number)
pg_field_num	(resource $result, string $field_name)
pg_field_size	(resource $result, int $field_number)
pg_field_type	(resource $result, int $field_number)
pg_free_result	(resource $result)
pg_get_result	([resource $connection])
pg_host	(resource $connection)
pg_insert	(resource $connection, string $table_name, array $assoc_array [, $bool $convert])
pg_last_error	(resource $connection)
pg_last_notice	(resource $connection)
pg_last_oid	(resource $result)
pg_lo_close	(resource $large_object)
pg_lo_create	(resource $connection)
pg_lo_export	(int $oid, string $pathname [, resource $connection])
pg_lo_import	(string $pathname [, resource $connection])
pg_lo_open	(resource $connection, int $oid, string $mode)
pg_lo_read	(resource $large_object, int $len)
pg_lo_read_all	(resource $large_object)
pg_lo_seek	(resource $large_object, int $offset [, int $whence])
pg_lo_tell	(resource $large_object)
pg_lo_unlink	(resource $connection, int $oid)
pg_lo_write	(resource $large_object, string $data)
pg_metadata	(resource $connection, string $table_name)
pg_num_fields	(resource $result)
pg_options	(resource $connection)
pg_pconnect	(string $connection_string)
pg_port	(resource $connection)
pg_put_line	([resource $connection, string $data])
pg_query	(resource $connection, string $query)
pg_result_error	(resource $result)
pg_result_status	(resource $result)
pg_select	(resource $connection, string $table_name, array $assoc_array [, $bool $convert])
pg_send_query	(resource $connection, string $query)
pg_send_query	(string $query)
pg_set_client_encoding	([resource $connection, string $encoding])
pg_trace	(string $pathname [, string $mode [, resource $connection]])
pg_tty	(resource $connection)
pg_untrace	([resource $connection])
pg_update	(resource $connection, string $table_name, array $condition, array $data [, $bool $convert])
php_logo_guid	(void)
php_sapi_name	(void)
php_uname	(void)
phpcredits	([int $flag])
phpinfo	([int $what])
phpversion	(void)
pi	(void)
popen	(string $command, string $mode)
pos	(array $array)
posix_ctermid	(void)
posix_getcwd	(void)
posix_getegid	(void)
posix_geteuid	(void)
posix_getgid	(void)
posix_getgrgid	(int $gid)
posix_getgrnam	(string $name)
posix_getgroups	(void)
posix_getlogin	(void)
posix_getpgid	(int $pid)
posix_getpgrp	(void)
posix_getpid	(void)
posix_getppid	(void)
posix_getpwnam	(string $username)
posix_getpwuid	(int $uid)
posix_getsid	(int $pid)
posix_getuid	(void)
posix_isatty	(int $fd)
posix_kill	(int $pid, int $sig)
posix_mkfifo	(string $pathname, int $mode)
posix_setegid	(int $gid)
posix_seteuid	(int $uid)
posix_setgid	(int $gid)
posix_setpgid	(int $pid, int $pgid)
posix_setsid	(void)
posix_setuid	(int $uid)
posix_times	(void)
posix_ttyname	(int $fd)
posix_uname	(void)
preg_grep	(string $pattern, array $input)
preg_match	(string $pattern, string $subject [, array $matches])
preg_match_all	(string $pattern, string $subject, array $matches [, int $order])
preg_quote	(string $str [, string $delimiter])
preg_replace	(mixed $pattern, $mixed $replacement, $mixed $subject [, int $limit])
preg_replace_callback	(mixed $pattern, $mixed $callback, $mixed $subject [, int $limit])
prev	(array $array)
print	(string $arg)
print_r	(mixed $expression)
printer_abort	(resource $handle)
printer_close	(resource $handle)
printer_create_dc	(resource $handle)
printer_create_font	(string $face, int $height, int $width, int $font_weight, $bool $italic, $bool $underline, $bool $strikeout, int $orientaton)
printer_create_pen	(int $style, int $width, string $color)
printer_delete_brush	(resource $handle)
printer_delete_dc	(resource $handle)
printer_delete_font	(resource $handle)
printer_delete_pen	(resource $handle)
printer_draw_bmp	(resource $handle, string $filename, int $x, int $y)
printer_draw_chord	(resource $handle, int $rec_x, int $rec_y, int $rec_x1, int $rec_y1, int $rad_x, int $rad_y, int $rad_x1, int $rad_y1)
printer_draw_elipse	(resource $handle, int $ul_x, int $ul_y, int $lr_x, int $lr_y)
printer_draw_line	(resource $printer_handle, int $from_x, int $from_y, int $to_x, int $to_y)
printer_draw_pie	(resource $handle, int $rec_x, int $rec_y, int $rec_x1, int $rec_y1, int $rad1_x, int $rad1_y, int $rad2_x, int $rad2_y)
printer_draw_rectangle	(resource $handle, int $ul_x, int $ul_y, int $lr_x, int $lr_y)
printer_draw_roundrect	(resource $handle, int $ul_x, int $ul_y, int $lr_x, int $lr_y, int $width, int $height)
printer_end_doc	(resource $handle)
printer_end_page	(resource $handle)
printer_get_option	(resource $handle, string $option)
printer_list	(int $enumtype [, string $name [, int $level]])
printer_logical_fontheight	(resource $handle, int $height)
printer_select_brush	(resource $printer_handle, resource $brush_handle)
printer_select_font	(resource $printer_handle, resource $font_handle)
printer_select_pen	(resource $printer_handle, resource $pen_handle)
printer_set_option	(resource $handle, int $option, $mixed $value)
printer_start_doc	(resource $handle [, string $document])
printer_start_page	(resource $handle)
printer_write	(resource $handle, string $content)
printf	(string $format [, $mixed $args])
proc_close	(resource $process)
pspell_add_to_session	(int $dictionary_link, string $word)
pspell_check	(int $dictionary_link, string $word)
pspell_clear_session	(int $dictionary_link)
pspell_config_create	(string $language [, string $spelling [, string $jargon [, string $encoding]]])
pspell_config_ignore	(int $dictionary_link, int $n)
pspell_config_mode	(int $dictionary_link, int $mode)
pspell_config_personal	(int $dictionary_link, string $file)
pspell_config_repl	(int $dictionary_link, string $file)
pspell_config_runtogether	(int $dictionary_link, $bool $flag)
pspell_config_save_repl	(int $dictionary_link, $bool $flag)
pspell_new	(string $language [, string $spelling [, string $jargon [, string $encoding [, int $mode]]]])
pspell_new_config	(int $config)
pspell_new_personal	(string $personal, string $language [, string $spelling [, string $jargon [, string $encoding [, int $mode]]]])
pspell_save_wordlist	(int $dictionary_link)
pspell_store_replacement	(int $dictionary_link, string $misspelled, string $correct)
pspell_suggest	(int $dictionary_link, string $word)
putenv	(string $setting)
qdom_error	(void)
qdom_tree	(string $)
quotemeta	(string $str)
rad2deg	(float $number)
rand	([int $min, int $max])
range	(mixed $low, $mixed $high)
rawurldecode	(string $str)
rawurlencode	(string $str)
read	(string $buffer, $integer $len)
readdir	(resource $dir_handle)
readfile	(string $filename [, int $use_include_path])
readgzfile	(string $filename [, int $use_include_path])
readline_add_history	(string $line)
readline_clear_history	(void)
readline_completion_function	(string $line)
readline_info	([string $varname [, string $newvalue]])
readline_list_history	(void)
readline_read_history	(string $filename)
readline_write_history	(string $filename)
readlink	(string $path)
realpath	(string $path)
reason	(void $)
recode	(string $request, string $string)
recode_file	(string $request, resource $input, resource $output)
recode_string	(string $request, string $string)
register_shutdown_function	(string $func)
register_tick_function	(string $func [, $mixed $arg])
remove	(array $parameter)
remove	(string $name)
rename	(string $oldname, string $newname)
replace	(array $parameter)
reset	(array array)
restore_error_handler	(void)
rewind	(int $fp)
rewinddir	(resource $dir_handle)
round	(float $val [, int $precision])
rsort	(array $array [, int $sort_flags])
rtrim	(string $str [, string $charlist])
sem_acquire	(int $sem_identifier)
sem_get	(int $key [, int $max_acquire [, int $perm]])
sem_release	(int $sem_identifier)
sem_remove	(int $sem_identifier)
serialize	(mixed $value)
sesam_affected_rows	(string $result_id)
sesam_commit	(void)
sesam_connect	(string $catalog, string $schema, string $user)
sesam_diagnostic	(void)
sesam_disconnect	(void)
sesam_errormsg	(void)
sesam_execimm	(string $query)
sesam_fetch_array	(string $result_id [, int $whence [, int $offset]])
sesam_fetch_result	(string $result_id [, int $max_rows])
sesam_fetch_row	(string $result_id [, int $whence [, int $offset]])
sesam_field_array	(string $result_id)
sesam_field_name	(string $result_id, int $index)
sesam_num_fields	(string $result_id)
sesam_query	(string $query [, $bool $scrollable])
sesam_rollback	(void)
sesam_seek_row	(string $result_id, int $whence [, int $offset])
sesam_settransaction	(int $isolation_level, int $read_only)
session_cache_expire	([int $new_cache_expire])
session_cache_limiter	([string $cache_limiter])
session_decode	(string $data)
session_destroy	(void)
session_encode	(void)
session_get_cookie_params	(void)
session_id	([string $id])
session_is_registered	(string $name)
session_module_name	([string $module])
session_name	([string $name])
session_readonly	(void)
session_register	(mixed $name [, $mixed $...])
session_set_save_handler	(string $open, string $close, string $read, string $write, string $destroy, string $gc)
session_start	(void)
session_unregister	(string $name)
session_unset	(void)
session_write_close	(void)
set_file_buffer	(int $fp, int $buffer)
set_magic_quotes_runtime	(int $new_setting)
set_time_limit	(int $seconds)
setcommitedversion	(array $parameter)
setcookie	(string $name [, string $value [, int $expire [, string $path [, string $domain [, int $secure]]]]])
setlocale	(mixed $category, string $locale)
settype	(mixed $var, string $type)
shell_exec	(string $cmd)
shm_attach	(int $key [, int $memsize [, int $perm]])
shm_detach	(int $shm_identifier)
shm_get_var	(int $id, int $variable_key)
shm_put_var	(int $shm_identifier, int $variable_key, $mixed $variable)
shm_remove	(int $shm_identifier)
shm_remove_var	(int $id, int $variable_key)
shmop_close	(int $shmid)
shmop_delete	(int $shmid)
shmop_open	(int $key, string $flags, int $mode, int $size)
shmop_read	(int $shmid, int $start, int $count)
shmop_size	(int $shmid)
shmop_write	(int $shmid, string $data, int $offset)
show_source	(string $filename [, $bool $return])
shuffle	(array array)
similar_text	(string $first, string $second [, $float $percent])
sin	(float $arg)
sinh	(float $arg)
sizeof	(mixed $var)
sleep	(int $seconds)
snmp_get_quick_print	(void)
snmp_set_quick_print	(bool $quick_print)
snmprealwalk	(string $host, string $community, string $object_id [, int $timeout [, int $retries]])
snmpset	(string $hostname, string $community, string $object_id, string $type, $mixed $value [, int $timeout [, int $retries]])
snmpwalk	(string $hostname, string $community, string $object_id [, int $timeout [, int $retries]])
snmpwalkoid	(string $hostname, string $community, string $object_id [, int $timeout [, int $retries]])
socket_accept	(resource $socket)
socket_bind	(resource $socket, string $address [, int $port])
socket_close	(resource $socket)
socket_connect	(resource $socket, string $address [, int $port])
socket_create	(int $domain, int $type, int $protocol)
socket_create_listen	(int $port [, int $backlog])
socket_create_pair	(int $domain, int $type, int $protocol, array $&#38;fd)
socket_fd_alloc	(void)
socket_fd_clear	(resource $set, $mixed $socket)
socket_fd_free	(resource $set)
socket_fd_isset	(resource $set, resource $socket)
socket_fd_set	(resource $set, $mixed $socket)
socket_fd_zero	(resource $set)
socket_get_status	(resource $socketstream)
socket_getopt	(resource $socket, int $level, int $optname)
socket_getpeername	(resource $socket, string $&#38;addr [, int $&#38;port])
socket_getsockname	(resource $socket, string $&#38;addr [, int $&#38;port])
socket_iovec_add	(resource $iovec, int $iov_len)
socket_iovec_alloc	(int $num_vectors [, int $])
socket_iovec_delete	(resource $iovec, int $iov_pos)
socket_iovec_fetch	(resource $iovec, int $iovec_position)
socket_iovec_free	(resource $iovec)
socket_iovec_set	(resource $iovec, int $iovec_position, string $new_val)
socket_last_error	(resource $socket)
socket_listen	(resource $socket, int $backlog)
socket_read	(resource $socket_des, int $length [, int $type])
socket_readv	(resource $socket, resource $iovec_id)
socket_recv	(resource $socket, int $len, int $flags)
socket_recvfrom	(resource $socket, string $&#38;buf, int $len, int $flags, string $&#38;name [, int $&#38;port])
socket_recvmsg	(resource $socket, resource $iovec, array $&#38;control, int $&#38;controllen, int $&#38;flags, string $&#38;addr [, int $&#38;port])
socket_select	(resource $read_fd, resource $write_fd, resource $except_fd, int $tv_sec [, int $tv_usec])
socket_send	(resource $socket, string $buf, int $len, int $flags)
socket_sendmsg	(resource $socket, resource $iovec, int $flags, string $addr [, int $port])
socket_sendto	(resource $socket, string $buf, int $len, int $flags, string $addr [, int $port])
socket_set_blocking	(int $socket $descriptor, int $mode)
socket_set_nonblock	(resource $socket)
socket_set_timeout	(int $socket $descriptor, int $seconds, int $microseconds)
socket_setopt	(resource $socket, int $level, int $optname, int $)
socket_shutdown	(resource $socket [, int $how])
socket_strerror	(int $errno)
socket_write	(resource $socket_des, string $&#38;buffer, int $length)
socket_writev	(resource $socket, resource $iovec_id)
sort	(array array [, int $sort_flags])
soundex	(string $str)
split	(string $pattern, string $string [, int $limit])
spliti	(string $pattern, string $string [, int $limit])
sprintf	(string $format [, $mixed $args])
sql_regcase	(string string)
sqrt	(float $arg)
srand	(int $seed)
srcanchors	(array $parameter)
srcsofdst	(array $parameter)
sscanf	(string $str, string $format [, string $var1])
stat	(string $filename)
str_pad	(string $input, int $pad_length [, string $pad_string [, int $pad_type]])
str_repeat	(string $input, int $multiplier)
str_replace	(mixed $search, mixed $replace, mixed $subject)
str_rot13	(string $str)
strcasecmp	(string $str1, string $str2)
strchr	(string $haystack, string $needle)
strcmp	(string $str1, string $str2)
strcoll	(string $str1, string $str2)
strcspn	(string $str1, string $str2)
strftime	(string $format [, int $timestamp])
strip_tags	(string $str [, string $allowable_tags])
stripcslashes	(string $str)
stripslashes	(string $str)
stristr	(string $haystack, string $needle)
strlen	(string $str)
strnatcasecmp	(string $str1, string $str2)
strnatcmp	(string $str1, string $str2)
strncasecmp	(string $str1, string $str2, int $len)
strncmp	(string $str1, string $str2, int $len)
strpos	(string $haystack, string $needle [, int $offset])
strrchr	(string $haystack, string $needle)
strrev	(string string)
strrpos	(string $haystack, $char $needle)
strspn	(string $str1, string $str2)
strstr	(string $haystack, string $needle)
strtok	(string $arg1, string $arg2)
strtolower	(string $str)
strtotime	(string $time [, int $now])
strtoupper	(string $string)
strtr	(string $str, array $replace_pairs)
strtr	(string $str, string $from, string $to)
strval	(mixed $var)
substr	(string $string, int $start [, int $length])
substr_count	(string $haystack, string $needle)
swf_actiongeturl	(string $url, string $target)
swf_actiongotoframe	(int $framenumber)
swf_actiongotolabel	(string $label)
swf_actionnextframe	(void)
swf_actionplay	(void)
swf_actionprevframe	(void)
swf_actionsettarget	(string $target)
swf_actionstop	(void)
swf_actiontogglequality	(void)
swf_actionwaitforframe	(int $framenumber, int $skipcount)
swf_addbuttonrecord	(int $states, int $shapeid, int $depth)
swf_addcolor	(float $r, $float $g, $float $b, $float $a)
swf_closefile	([int $return_file])
swf_definebitmap	(int $objid, string $image_name)
swf_definefont	(int $fontid, string $fontname)
swf_defineline	(int $objid, $float $x1, $float $y1, $float $x2, $float $y2, $float $width)
swf_definepoly	(int $objid, array $coords, int $npoints, $float $width)
swf_definerect	(int $objid, $float $x1, $float $y1, $float $x2, $float $y2, $float $width)
swf_definetext	(int $objid, string $str, int $docenter)
swf_endbutton	(void)
swf_enddoaction	(void)
swf_endshape	(void)
swf_endsymbol	(void)
swf_fontsize	(float $size)
swf_fontslant	(float $slant)
swf_fonttracking	(float $tracking)
swf_getbitmapinfo	(int $bitmapid)
swf_getfontinfo	(void)
swf_getframe	(void)
swf_labelframe	(string $name)
swf_lookat	(float $view_x, $float $view_y, $float $view_z, $float $reference_x, $float $reference_y, $float $reference_z, $float $twist)
swf_mulcolor	(float $r, $float $g, $float $b, $float $a)
swf_nextid	(void)
swf_oncondition	(int $transition)
swf_openfile	(string $filename, $float $width, $float $height, $float $framerate, $float $r, $float $g, $float $b)
swf_ortho	(float $xmin, $float $xmax, $float $ymin, $float $ymax, $float $zmin, $float $zmax)
swf_ortho2	(float $xmin, $float $xmax, $float $ymin, $float $ymax)
swf_perspective	(float $fovy, $float $aspect, $float $near, $float $far)
swf_placeobject	(int $objid, int $depth)
swf_polarview	(float $dist, $float $azimuth, $float $incidence, $float $twist)
swf_popmatrix	(void)
swf_posround	(int $round)
swf_pushmatrix	(void)
swf_removeobject	(int $depth)
swf_rotate	(float $angle, string $axis)
swf_scale	(float $x, $float $y, $float $z)
swf_setfont	(int $fontid)
swf_setframe	(int $framenumber)
swf_shapearc	(float $x, $float $y, $float $r, $float $ang1, $float $ang2)
swf_shapecurveto	(float $x1, $float $y1, $float $x2, $float $y2)
swf_shapefillbitmapclip	(int $bitmapid)
swf_shapefillbitmaptile	(int $bitmapid)
swf_shapefilloff	(void)
swf_shapefillsolid	(float $r, $float $g, $float $b, $float $a)
swf_shapelinesolid	(float $r, $float $g, $float $b, $float $a, $float $width)
swf_shapelineto	(float $x, $float $y)
swf_shapemoveto	(float $x, $float $y)
swf_showframe	(void)
swf_startbutton	(int $objid, int $type)
swf_startdoaction	(void)
swf_startshape	(int $objid)
swf_startsymbol	(int $objid)
swf_textwidth	(string $str)
swf_translate	(float $x, $float $y, $float $z)
swf_viewport	(float $xmin, $float $xmax, $float $ymin, $float $ymax)
swfaction	(string $script)
swfbitmap-getheight	(void)
swfbitmap	(string $filename [, int $alphafilename])
swfbutton-addaction	(ressource $action, int $flags)
swfbutton-addshape	(ressource $shape, int $flags)
swfbutton-setaction	(ressource $action)
swfbutton-setdown	(ressource $shape)
swfbutton-sethit	(ressource $shape)
swfbutton-setover	(ressource $shape)
swfbutton-setup	(ressource $shape)
swfbutton	(void)
swfbutton_keypress	(string $str)
swfdisplayitem-addcolor	([int $red [, int $green [, int $blue [, int $a]]]])
swfdisplayitem-move	(int $dx, int $dy)
swfdisplayitem-moveto	(int $x, int $y)
swfdisplayitem-multcolor	([int $red [, int $green [, int $blue [, int $a]]]])
swfdisplayitem-remove	(void)
swfdisplayitem-rotate	(float $ddegrees)
swfdisplayitem-rotateto	(float $degrees)
swfdisplayitem-scale	(int $dx, int $dy)
swfdisplayitem-scaleto	(int $x, int $y)
swfdisplayitem-setdepth	(float $depth)
swfdisplayitem-setname	(string $name)
swfdisplayitem-setratio	(float $ratio)
swfdisplayitem-skewx	(float $ddegrees)
swfdisplayitem-skewxto	(float $degrees)
swfdisplayitem-skewy	(float $ddegrees)
swfdisplayitem-skewyto	(float $degrees)
swfdisplayitem	(void)
swffill-moveto	(int $x, int $y)
swffill-scaleto	(int $x, int $y)
swffill-skewyto	(float $y)
swffill	(void)
swffont-getwidth	(string string)
swffont	(string $filename)
swfgradient-addentry	(float $ratio, int $red, int $green, int $blue [, int $a])
swfgradient	(void)
swfmorph-getshape1	(void)
swfmorph-getshape2	(void)
swfmorph	(void)
swfmovie-add	(ressource $instance)
swfmovie-nextframe	(void)
swfmovie-output	(void)
swfmovie-remove	(resource $instance)
swfmovie-save	(string $filename)
swfmovie-setbackground	(int $red, int $green, int $blue)
swfmovie-setdimension	(int $width, int $height)
swfmovie-setframes	(string $numberofframes)
swfmovie-setrate	(int $rate)
swfmovie-streammp3	(string $mp3FileName)
swfmovie	(void)
swfshape-addfill	(int $red, int $green, int $blue [, int $a])
swfshape-drawcurve	(int $controldx, int $controldy, int $anchordx, int $anchordy)
swfshape-drawcurveto	(int $controlx, int $controly, int $anchorx, int $anchory)
swfshape-drawline	(int $dx, int $dy)
swfshape-drawlineto	(int $x, int $y)
swfshape-movepen	(int $dx, int $dy)
swfshape-movepento	(int $x, int $y)
swfshape-setleftfill	(swfgradient $fill)
swfshape-setline	(int $width [, int $red [, int $green [, int $blue [, int $a]]]])
swfshape-setrightfill	(swfgradient $fill)
swfshape	(void)
swfsprite-add	(resource $object)
swfsprite-nextframe	(void)
swfsprite-remove	(ressource $object)
swfsprite-setframes	(int $numberofframes)
swfsprite	(void)
swftext-addstring	(string $string)
swftext-addstring	(string $string)
swftext-moveto	(int $x, int $y)
swftext-setcolor	(int $red, int $green, int $blue [, int $a])
swftext-setfont	(string $font)
swftext-setheight	(int $height)
swftext-setspacing	(float $spacing)
swftext	(void)
swftextfield-addstring	(string string)
swftextfield-align	(int $alignement)
swftextfield-setbounds	(int $width, int $height)
swftextfield-setcolor	(int $red, int $green, int $blue [, int $a])
swftextfield-setfont	(string $font)
swftextfield-setheight	(int $height)
swftextfield-setindentation	(int $width)
swftextfield-setleftmargin	(int $width)
swftextfield-setlinespacing	(int $height)
swftextfield-setmargins	(int $left, int $right)
swftextfield-setname	(string $name)
swftextfield-setrightmargin	(int $width)
swftextfield	([int $flags])
sybase_affected_rows	([int $link_identifier])
sybase_close	(int $link_identifier)
sybase_connect	(string $servername, string $username, string $password [, string $charset])
sybase_data_seek	(int $result_identifier, int $row_number)
sybase_fetch_array	(int $result)
sybase_fetch_field	(int $result [, int $field_offset])
sybase_fetch_object	(int $result)
sybase_fetch_row	(int $result)
sybase_field_seek	(int $result, int $field_offset)
sybase_free_result	(int $result)
sybase_get_last_message	(void)
sybase_min_client_severity	(int $severity)
sybase_min_error_severity	(int $severity)
sybase_min_message_severity	(int $severity)
sybase_min_server_severity	(int $severity)
sybase_num_fields	(int $result)
sybase_num_rows	(int $result)
sybase_pconnect	(string $servername, string $username, string $password [, string $charset])
sybase_query	(string $query, int $link_identifier)
sybase_result	(int $result, int $row, $mixed $field)
sybase_select_db	(string $database_name, int $link_identifier)
symlink	(string $target, string $link)
syslog	(int $priority, string $message)
system	(string $command [, int $return_var])
tan	(float $arg)
tanh	(float $arg)
tempnam	(string $dir, string $prefix)
textdomain	(string $text_domain)
time	(void)
tmpfile	(void)
touch	(string $filename [, int $time])
trigger_error	(string $error_msg [, int $error_type])
trim	(string $str [, string $charlist])
uasort	(array $array, $function $cmp_function)
ucfirst	(string $str)
ucwords	(string $str)
udm_add_search_limit	(int $agent, int $var, string $val)
udm_alloc_agent	(string $dbaddr [, string $dbmode])
udm_api_version	(void)
udm_cat_list	(int $agent, string $category)
udm_cat_path	(int $agent, string $category)
udm_check_charset	(int $agent, string $charset)
udm_check_stored	(int $agent, int $link, string $doc_id)
udm_clear_search_limits	(int $agent)
udm_close_stored	(int $agent, int $link)
udm_crc32	(int $agent, string $str)
udm_errno	(int $agent)
udm_error	(int $agent)
udm_find	(int $agent, string $query)
udm_free_agent	(int $agent)
udm_free_ispell_data	(int $agent)
udm_free_res	(int $res)
udm_get_doc_count	(int $agent)
udm_get_res_field	(int $res, int $row, int $field)
udm_get_res_param	(int $res, int $param)
udm_load_ispell_data	(int $agent, int $var, string $val1, string $val2, int $flag)
udm_open_stored	(int $agent, string $storedaddr)
udm_set_agent_param	(int $agent, int $var, string $val)
uksort	(array $array, $function $cmp_function)
umask	(int $mask)
uniqid	(string $prefix [, $bool $lcg])
unixtojd	([int $timestamp])
unlink	(string $filename)
unpack	(string $format, string $data)
unregister_tick_function	(string $func [, $mixed $arg])
unserialize	(string $str)
unset	(mixed $var [, $mixed $var [, $...]])
urldecode	(string $str)
urlencode	(string $str)
user_error	(string $error_msg [, int $error_type])
usleep	(int $micro_seconds)
usort	(array $array, string $cmp_function)
utf8_decode	(string $data)
utf8_encode	(string $data)
var_dump	(mixed $expression [, $mixed $expression [, $...]])
var_export	(mixed $expression [, $bool $return])
version_compare	(string $version1, string $version2 [, string $operator])
virtual	(string $filename)
vpopmail_add_alias_domain	(string $domain, string $aliasdomain)
vpopmail_add_alias_domain_ex	(string $olddomain, string $newdomain)
vpopmail_add_domain	(string $domain, string $dir, int $uid, int $gid)
vpopmail_add_domain_ex	(string $domain, string $passwd [, string $quota [, string $bounce [, $bool $apop]]])
vpopmail_add_user	(string $user, string $domain, string $password [, string $gecos [, $bool $apop]])
vpopmail_alias_add	(string $user, string $domain, string $alias)
vpopmail_alias_del	(string $user, string $domain)
vpopmail_alias_del_domain	(string $domain)
vpopmail_alias_get	(string $alias, string $domain)
vpopmail_alias_get_all	(string $domain)
vpopmail_auth_user	(string $user, string $domain, string $password [, string $apop])
vpopmail_del_domain	(string $domain)
vpopmail_del_domain_ex	(string $domain)
vpopmail_del_user	(string $user, string $domain)
vpopmail_error	(void)
vpopmail_passwd	(string $user, string $domain, string $password)
vpopmail_set_user_quota	(string $user, string $domain, string $quota)
vprintf	(string $format, array $args)
vsprintf	(string $format, array $args)
w32api_deftype	(string $typename, string $member1_type, string $member1_name)
w32api_init_dtype	(string $typename, $mixed $val1, $mixed $val2)
w32api_invoke_function	(string $funcname)
w32api_register_function	(string $libary, string $function_name)
w32api_set_call_method	(int $method)
wddx_add_vars	(int $packet_id, $mixed $name_var [, $mixed $...])
wddx_deserialize	(string $packet)
wddx_packet_end	(int $packet_id)
wddx_packet_start	([string $comment])
wddx_serialize_value	(mixed $var [, string $comment])
wddx_serialize_vars	(mixed $var_name [, $mixed $...])
wordwrap	(string $str [, int $width [, string $br]])
xml_error_string	(int $code)
xml_get_current_byte_index	(resource $parser)
xml_get_current_column_number	(resource $parser)
xml_get_current_line_number	(resource $parser)
xml_get_error_code	(resource $parser)
xml_parse	(resource $parser, string $data [, $bool $is_final])
xml_parse_into_struct	(resource $parser, string $data, array $&#38;values, array $&#38;index)
xml_parser_create	([string $encoding])
xml_parser_create_ns	([string $encoding [, string $sep]])
xml_parser_free	(resource $parser)
xml_parser_get_option	(resource $parser, int $option)
xml_parser_set_option	(resource $parser, int $option, $mixed $value)
xml_set_character_data_handler	(resource $parser, string $handler)
xml_set_default_handler	(resource $parser, string $handler)
xml_set_element_handler	(resource $parser, string $start_element_handler, string $end_element_handler)
xml_set_end_namespace_decl_handler	(resource $pind, string $hdl)
xml_set_external_entity_ref_handler	(resource $parser, string $handler)
xml_set_notation_decl_handler	(resource $parser, string $handler)
xml_set_object	(int $parser, object &$object)
xml_set_processing_instruction_handler	(resource $parser, string $handler)
xml_set_start_namespace_decl_handler	(resource $pind, string $hdl)
xml_set_unparsed_entity_decl_handler	(resource $parser, string $handler)
xmlrpc_decode	(string $xml [, string $encoding])
xmlrpc_decode_request	(string $xml, string $method [, string $encoding])
xmlrpc_encode	(mixed $value)
xmlrpc_encode_request	(string $method, $mixed $params)
xmlrpc_get_type	(mixed $value)
xmlrpc_parse_method_descriptions	(string $xml)
xmlrpc_server_add_introspection_data	(resource $server, array $desc)
xmlrpc_server_call_method	(resource $server, string $xml, $mixed $user_data [, array $output_options])
xmlrpc_server_create	(void)
xmlrpc_server_destroy	(resource $server)
xmlrpc_server_register_introspection_callback	(resource $server, string $function)
xmlrpc_server_register_method	(resource $server, string $method_name, string $function)
xmlrpc_set_type	(string $value, string $type)
xpath_eval	(object $xpath $context)
xpath_eval_expression	(object $xpath_context)
xpath_new_context	(object $dom $document)
xptr_eval	([object $xpath_context, string $eval_str])
xptr_new_context	([object $doc_handle])
xslt_create	(void)
xslt_errno	(resource $xh)
xslt_error	(resource $xh)
xslt_free	(resource $xh)
xslt_process	(resource $xh, string $xml, string $xsl [, string $result [, array $arguments [, array $parameters]]])
xslt_set_base	(resource $xh, string $uri)
xslt_set_encoding	(resource $xh, string $encoding)
xslt_set_error_handler	(resource $xh, $mixed $handler)
xslt_set_log	(resource $xh, $mixed $log)
xslt_set_sax_handler	(resource $xh, array $handlers)
xslt_set_sax_handlers	(resource $processor, array $handlers)
xslt_set_scheme_handler	(resource $xh, array $handlers)
xslt_set_scheme_handlers	(resource $processor, array $handlers)
yaz_addinfo	(int $id)
yaz_ccl_conf	(int $id, array $config)
yaz_ccl_parse	(int $id, string $query, array &$result)
yaz_close	(int $id)
yaz_connect	(string $zurl [, $mixed $options])
yaz_database	(int $id, string $databases)
yaz_element	(int $id, string $elementset)
yaz_errno	(int $id)
yaz_error	(int $id)
yaz_hits	(int $id)
yaz_itemorder	(array $args)
yaz_present	(void)
yaz_range	(int $id, int $start, int $number)
yaz_record	(int $id, int $pos, string $type)
yaz_scan	(int $id, string $type, string $startterm [, array $flags])
yaz_scan_result	(int $id [, array &$result])
yaz_search	(int $id, string $type, string $query)
yaz_sort	(int $id, string $criteria)
yaz_syntax	(int $id, string $syntax)
yaz_wait	([ array $options])
yp_all	(string $domain, string $map, string $callback)
yp_cat	(string $domain, string $map)
yp_err_string	(void)
yp_errno	(void)
yp_first	(string $domain, string $map)
yp_get_default_domain	(void)
yp_master	(string $domain, string $map)
yp_match	(string $domain, string $map, string $key)
yp_next	(string $domain, string $map, string $key)
yp_order	(string $domain, string $map)
zend_logo_guid	(void)
zend_version	(void)
zip_close	(resource $zip)
zip_entry_close	(resource $zip_entry)
zip_entry_compressedsize	(resource $zip_entry)
zip_entry_compressionmethod	(resource $zip_entry)
zip_entry_filesize	(resource $zip_entry)
zip_entry_name	(resource $zip_entry)
zip_entry_open	(resource $zip, resource $zip_entry [, string $mode])
zip_entry_read	(resource $zip_entry [, int $length])
zip_open	(string $filename)
zip_read	(resource $zip)
